Customer_ID,Recency,Frequency,Monetary,R_Score,F_Score,M_Score,RFM_Score,Loyalty_Level
1,103,48,2461.6407298883623,4,5,3,12,1
2,349,13,3279.3572502475686,1,2,4,7,2
3,271,22,2899.848304609996,2,3,3,8,2
4,107,35,708.6024086767051,4,4,1,9,2
5,72,47,815.2531238589984,5,5,1,11,1
6,189,22,3360.2411140766912,3,3,4,10,1
7,21,28,4046.457387487983,5,3,5,13,0
8,103,21,4541.291268622659,4,3,5,12,1
9,122,46,4069.921461577123,4,5,5,14,0
10,215,18,4869.880155647102,3,2,5,10,1
11,331,31,2047.1765027840256,1,4,3,8,2
12,88,46,1662.5171135679511,4,5,2,11,1
13,100,37,150.63842120213332,4,4,1,9,2
14,360,21,2254.9803213805862,1,3,3,7,2
15,152,14,3260.3440465420304,3,2,4,9,2
16,131,25,4078.8891201991532,4,3,5,12,1
17,150,27,1344.6023600441079,3,3,2,8,2
18,309,40,2572.8204690827592,1,4,3,8,2
19,258,23,3313.4277274240926,2,3,4,9,2
20,344,31,2762.4983012606285,1,4,3,8,2
21,294,47,1377.3633798380147,1,5,2,8,2
22,192,29,3983.4493670923607,3,3,4,10,1
23,277,47,875.0714522349491,2,5,1,8,2
24,161,30,4525.849370593956,3,3,5,11,1
25,314,26,4763.457777783508,1,3,5,9,2
26,22,20,1834.2105777555578,5,2,2,9,2
27,253,38,1887.1471345248995,2,4,2,8,2
28,236,19,3718.9585119967987,2,2,4,8,2
29,345,27,2286.8801067744835,1,3,3,7,2
30,49,25,152.7646165601836,5,3,1,9,2
31,59,40,4600.184871099453,5,4,5,14,0
32,170,38,2159.4442064091563,3,4,3,10,1
33,188,23,1025.4405516961533,3,3,2,8,2
34,271,29,2782.7637250124426,2,3,3,8,2
35,190,15,1102.3417513306697,3,2,2,7,2
36,175,3,1038.049778411223,3,1,2,6,3
37,51,10,2733.1993236792573,5,1,3,9,2
38,364,15,1961.3010380254507,1,2,2,5,3
39,55,16,2869.2364584835796,5,2,3,10,1
40,244,17,4984.158929688089,2,2,5,9,2
41,320,19,4296.500590310134,1,2,5,8,2
42,131,11,48.27728845604589,4,2,1,7,2
43,307,48,262.27299059157485,1,5,1,7,2
44,135,5,3054.2964062549104,4,1,4,9,2
45,21,5,3135.017844850167,5,1,4,10,1
46,329,14,4392.172311939207,1,2,5,8,2
47,167,26,3148.9953008639104,3,3,4,10,1
48,274,8,1146.295547193554,2,1,2,5,3
49,89,5,2347.895976241218,4,1,3,8,2
50,316,7,4046.837149349231,1,1,5,7,2
51,14,16,4614.896573345874,5,2,5,12,1
52,242,14,1192.2064436438786,2,2,2,6,3
53,265,37,2702.627627716496,2,4,3,9,2
54,346,41,803.0484753503096,1,5,1,7,2
55,53,4,2490.0284976485705,5,1,3,9,2
56,340,36,459.66946254001044,1,4,1,6,3
57,92,48,4709.223069052866,4,5,5,14,0
58,264,17,3193.9017268302514,2,2,4,8,2
59,35,47,4272.541541151249,5,5,5,15,0
60,206,36,4991.492919167712,3,4,5,12,1
61,81,6,921.5033135798375,4,1,1,6,3
62,50,16,3473.7756406486465,5,2,4,11,1
63,360,29,4436.061604599222,1,3,5,9,2
64,2,36,2883.931455384832,5,4,3,12,1
65,54,38,3202.0849280491393,5,4,4,13,0
66,106,37,2044.2787366905154,4,4,3,11,1
67,260,48,3377.056560245405,2,5,4,11,1
68,310,48,1983.9337943336577,1,5,2,8,2
69,191,10,2388.3319943757274,3,1,3,7,2
70,218,41,523.5295956878962,2,5,1,8,2
71,44,36,48.96391690010442,5,4,1,10,1
72,162,29,285.20410945334476,3,3,1,7,2
73,202,14,970.6829882786326,3,2,1,6,3
74,270,4,2288.453059779376,2,1,3,6,3
75,351,44,114.76041354875488,1,5,1,7,2
76,304,42,788.1238293796202,1,5,1,7,2
77,271,36,3909.4085733833485,2,4,4,10,1
78,215,45,3813.2111257276147,3,5,4,12,1
79,252,13,3950.7541554607446,2,2,4,8,2
80,190,46,4608.489306551902,3,5,5,13,0
81,296,18,604.1642936652505,1,2,1,4,3
82,213,33,824.0679823771359,3,4,1,8,2
83,208,21,1674.4325368605587,3,3,2,8,2
84,237,16,4576.554582914739,2,2,5,9,2
85,338,15,3879.6339375996654,1,2,4,7,2
86,53,5,1627.3651489382753,5,1,2,8,2
87,280,6,447.30273073584704,2,1,1,4,3
88,217,38,3085.736330482682,3,4,4,11,1
89,252,3,1291.5276373702052,2,1,2,5,3
90,188,48,2660.45130418308,3,5,3,11,1
91,41,12,4709.598764408875,5,2,5,12,1
92,157,36,2867.3600541185288,3,4,3,10,1
93,15,33,4619.933837752587,5,4,5,14,0
94,301,36,1971.2635421144282,1,4,2,7,2
95,65,33,3170.4231730709657,5,4,4,13,0
96,345,31,4470.510969995352,1,4,5,10,1
97,327,21,2944.0566849296006,1,3,3,7,2
98,9,27,3078.34439836525,5,3,4,12,1
99,344,27,3584.37683058531,1,3,4,8,2
100,129,8,4411.717708369383,4,1,5,10,1
101,136,37,450.01850559185635,4,4,1,9,2
102,63,32,1690.9283170586737,5,4,2,11,1
103,139,26,1994.446783142213,4,3,2,9,2
104,81,2,4549.451230291997,4,1,5,10,1
105,163,12,4780.479543335845,3,2,5,10,1
106,289,22,610.6985186789725,2,3,1,6,3
107,261,17,604.3473221460162,2,2,1,5,3
108,231,7,4674.9603533192885,2,1,5,8,2
109,41,43,1485.9017878991374,5,5,2,12,1
110,28,4,1216.653950995392,5,1,2,8,2
111,135,37,187.7581001129524,4,4,1,9,2
112,201,38,1385.2237145055387,3,4,2,9,2
113,328,32,3470.6968718576813,1,4,4,9,2
114,268,11,2135.920452070413,2,2,3,7,2
115,33,1,2589.1830547422833,5,1,3,9,2
116,48,25,4587.3050271082775,5,3,5,13,0
117,62,42,582.3020155298692,5,5,1,11,1
118,216,24,365.49116906056906,3,3,1,7,2
119,293,43,4261.134438128232,1,5,5,11,1
120,99,17,3876.530429179226,4,2,4,10,1
121,172,8,1326.033592855712,3,1,2,6,3
122,360,45,1627.9282906066735,1,5,2,8,2
123,214,27,1558.2864005205447,3,3,2,8,2
124,35,18,3242.5659021293372,5,2,4,11,1
125,227,27,315.4454198750071,2,3,1,6,3
126,101,22,2452.1139104659974,4,3,3,10,1
127,131,16,678.0261158725983,4,2,1,7,2
128,257,2,4100.495319221975,2,1,5,8,2
129,5,5,1909.5083915067266,5,1,2,8,2
130,218,18,2642.585244165102,2,2,3,7,2
131,255,3,156.294867806142,2,1,1,4,3
132,359,27,300.7389245698511,1,3,1,5,3
133,283,17,3378.5236053599956,2,2,4,8,2
134,207,16,3836.185020255247,3,2,4,9,2
135,15,6,3553.077567164985,5,1,4,10,1
136,346,7,3687.7229959247225,1,1,4,6,3
137,42,14,532.0530542411516,5,2,1,8,2
138,179,38,3470.31969707673,3,4,4,11,1
139,63,40,916.9204376185772,5,4,1,10,1
140,352,15,499.0970050651592,1,2,1,4,3
141,231,47,3788.232543969657,2,5,4,11,1
142,241,47,4448.136524336808,2,5,5,12,1
143,52,48,3586.382437951742,5,5,4,14,0
144,96,33,4029.811529545619,4,4,5,13,0
145,222,43,4955.529894056863,2,5,5,12,1
146,231,27,682.4319979193558,2,3,1,6,3
147,237,29,4826.111236640862,2,3,5,10,1
148,143,37,3009.9770493956116,4,4,3,11,1
149,171,5,4068.133255151652,3,1,5,9,2
150,29,29,3254.3442161224734,5,3,4,12,1
151,36,32,2854.4885660388923,5,4,3,12,1
152,13,6,3521.0587801682223,5,1,4,10,1
153,160,2,1608.090735919784,3,1,2,6,3
154,327,6,4622.1149022246445,1,1,5,7,2
155,187,46,585.3099345583357,3,5,1,9,2
156,243,43,1596.975608591446,2,5,2,9,2
157,86,4,165.50014247051152,4,1,1,6,3
158,284,29,1363.9020077539976,2,3,2,7,2
159,66,25,1098.8832549356077,5,3,2,10,1
160,170,9,257.6579947863697,3,1,1,5,3
161,45,3,2463.9525786046243,5,1,3,9,2
162,62,26,2348.493848859493,5,3,3,11,1
163,134,48,397.9497650543577,4,5,1,10,1
164,284,43,1316.6341517279868,2,5,2,9,2
165,28,27,4767.077580727117,5,3,5,13,0
166,108,36,562.5757563069974,4,4,1,9,2
167,44,32,1532.0430578087462,5,4,2,11,1
168,340,1,188.95336828874616,1,1,1,3,3
169,286,16,752.9471410925961,2,2,1,5,3
170,331,48,3499.99156625429,1,5,4,10,1
171,128,11,1839.9153383080647,4,2,2,8,2
172,348,26,2265.8620876888117,1,3,3,7,2
173,231,40,793.3221917019741,2,4,1,7,2
174,190,1,3413.8794627275956,3,1,4,8,2
175,225,26,3760.092774475356,2,3,4,9,2
176,283,28,913.7491270885314,2,3,1,6,3
177,121,9,234.5173834635114,4,1,1,6,3
178,116,44,413.89626020200234,4,5,1,10,1
179,233,22,3288.6583284430585,2,3,4,9,2
180,259,8,686.1979064492463,2,1,1,4,3
181,359,49,2474.6549825024895,1,5,3,9,2
182,198,42,771.6812393215886,3,5,1,9,2
183,137,27,859.0387605441464,4,3,1,8,2
184,318,39,31.75891167417785,1,4,1,6,3
185,165,19,1610.9130367333557,3,2,2,7,2
186,225,25,458.08835770357297,2,3,1,6,3
187,307,38,1975.8667639487219,1,4,2,7,2
188,234,21,2992.9437049917437,2,3,3,8,2
189,172,24,1843.9844201613034,3,3,2,8,2
190,152,24,3528.357337868323,3,3,4,10,1
191,315,19,3709.844322516397,1,2,4,7,2
192,160,47,3486.065872930451,3,5,4,12,1
193,96,2,4684.200662561176,4,1,5,10,1
194,233,14,1194.0984422058036,2,2,2,6,3
195,180,32,955.3877010437333,3,4,1,8,2
196,113,42,3052.460331316917,4,5,4,13,0
197,318,32,2978.436277076575,1,4,3,8,2
198,52,28,2555.3906850372873,5,3,3,11,1
199,268,48,31.72242555637984,2,5,1,8,2
200,295,39,2780.6387672309324,1,4,3,8,2
201,113,40,4664.662303796165,4,4,5,13,0
202,101,42,1679.5426686731857,4,5,2,11,1
203,113,47,4838.31997466805,4,5,5,14,0
204,81,40,1790.2158291964945,4,4,2,10,1
205,187,13,707.873967563911,3,2,1,6,3
206,113,12,1998.033040486421,4,2,2,8,2
207,2,8,2478.110451488485,5,1,3,9,2
208,130,15,3151.0274067811897,4,2,4,10,1
209,220,26,2529.342028491447,2,3,3,8,2
210,54,12,2688.2259507570284,5,2,3,10,1
211,343,43,130.0945214044508,1,5,1,7,2
212,224,46,1275.5646439786067,2,5,2,9,2
213,225,27,1560.3763231164683,2,3,2,7,2
214,126,18,4935.571804028431,4,2,5,11,1
215,130,45,1484.883015050298,4,5,2,11,1
216,53,36,4483.928455633183,5,4,5,14,0
217,172,49,1530.633640699983,3,5,2,10,1
218,218,27,489.5905519015315,2,3,1,6,3
219,160,9,1245.6108213141124,3,1,2,6,3
220,198,39,1371.4136407223468,3,4,2,9,2
221,247,1,4891.460483506031,2,1,5,8,2
222,324,7,3374.7146127805136,1,1,4,6,3
223,203,26,4659.08816814862,3,3,5,11,1
224,184,7,4176.625160802061,3,1,5,9,2
225,123,7,2897.206468483707,4,1,3,8,2
226,255,8,3380.185741985361,2,1,4,7,2
227,294,16,3127.9375965431973,1,2,4,7,2
228,280,3,3334.6525006970155,2,1,4,7,2
229,325,45,1331.2205864901084,1,5,2,8,2
230,98,10,2046.544419697606,4,1,3,8,2
231,198,7,2967.1528998747503,3,1,3,7,2
232,240,21,189.283040628727,2,3,1,6,3
233,144,37,2419.34615799445,4,4,3,11,1
234,97,31,4300.037397655287,4,4,5,13,0
235,201,23,2466.9149606507963,3,3,3,9,2
236,124,27,2766.093609590942,4,3,3,10,1
237,187,22,1017.5065513708022,3,3,1,7,2
238,326,39,3973.773286487335,1,4,4,9,2
239,349,27,1800.802657307269,1,3,2,6,3
240,259,49,4783.3718918629265,2,5,5,12,1
241,148,4,4968.636893215301,3,1,5,9,2
242,252,24,4580.842707553256,2,3,5,10,1
243,346,23,433.53495663255825,1,3,1,5,3
244,147,48,1672.583945925174,3,5,2,10,1
245,148,19,4726.236799161562,3,2,5,10,1
246,352,42,4024.6211412737434,1,5,5,11,1
247,199,3,4556.806110644074,3,1,5,9,2
248,308,27,2867.040436269083,1,3,3,7,2
249,128,3,2407.183965055776,4,1,3,8,2
250,39,28,541.4166218522108,5,3,1,9,2
251,338,17,4198.962996192265,1,2,5,8,2
252,360,31,3728.256326618188,1,4,4,9,2
253,129,10,303.7942490469069,4,1,1,6,3
254,267,49,1054.978802080474,2,5,2,9,2
255,151,22,2790.815040941902,3,3,3,9,2
256,298,30,3425.167986302547,1,3,4,8,2
257,99,49,696.9746186624224,4,5,1,10,1
258,263,21,1231.675844126996,2,3,2,7,2
259,252,36,973.6199564279798,2,4,1,7,2
260,144,23,1107.7857918260056,4,3,2,9,2
261,346,38,4604.358486608146,1,4,5,10,1
262,112,12,3581.939669463383,4,2,4,10,1
263,60,25,3688.1638322124836,5,3,4,12,1
264,2,20,3972.03660123772,5,2,4,11,1
265,304,49,1789.2994827938594,1,5,2,8,2
266,254,49,3838.2512258517113,2,5,4,11,1
267,140,42,4892.282837671456,4,5,5,14,0
268,37,7,3494.9872872453006,5,1,4,10,1
269,160,29,2089.59803033977,3,3,3,9,2
270,9,48,3584.635330697764,5,5,4,14,0
271,233,29,4504.965554311718,2,3,5,10,1
272,99,13,652.5201029431082,4,2,1,7,2
273,147,3,1333.8204311677598,3,1,2,6,3
274,304,2,4597.288114491237,1,1,5,7,2
275,208,16,4731.70217321819,3,2,5,10,1
276,131,30,2425.8542443185456,4,3,3,10,1
277,152,38,1879.0093073824546,3,4,2,9,2
278,54,6,1421.081209959116,5,1,2,8,2
279,120,45,2498.7701900439324,4,5,3,12,1
280,161,7,4673.310446439348,3,1,5,9,2
281,116,5,757.5500408480328,4,1,1,6,3
282,75,7,2104.954886350629,4,1,3,8,2
283,113,34,4558.92320621787,4,4,5,13,0
284,104,32,1752.105158019817,4,4,2,10,1
285,340,49,3842.7262211472503,1,5,4,10,1
286,254,13,1952.406333343099,2,2,2,6,3
287,227,30,4026.584124831978,2,3,5,10,1
288,112,25,4905.201726286471,4,3,5,12,1
289,99,21,1945.231832770639,4,3,2,9,2
290,153,21,4227.042286325261,3,3,5,11,1
291,349,28,4942.199955953101,1,3,5,9,2
292,338,48,4919.312413626159,1,5,5,11,1
293,194,20,2174.517696851207,3,2,3,8,2
294,310,34,2433.9479915402585,1,4,3,8,2
295,163,5,1523.97379259858,3,1,2,6,3
296,208,18,1576.9536309746015,3,2,2,7,2
297,169,39,2467.428406934854,3,4,3,10,1
298,161,43,1010.5877644209005,3,5,1,9,2
299,68,11,3558.5052478130883,5,2,4,11,1
300,289,17,2686.179588423719,2,2,3,7,2
301,277,48,4491.358607294679,2,5,5,12,1
302,304,45,4054.806344714599,1,5,5,11,1
303,135,22,1619.1308531022116,4,3,2,9,2
304,195,37,2533.96506885816,3,4,3,10,1
305,128,20,3755.069488917483,4,2,4,10,1
306,33,48,974.0686361171744,5,5,1,11,1
307,176,48,167.67267178974095,3,5,1,9,2
308,22,48,4262.999586278336,5,5,5,15,0
309,238,46,696.3757848898117,2,5,1,8,2
310,158,6,4448.163040458995,3,1,5,9,2
311,38,34,4568.904039166911,5,4,5,14,0
312,230,14,2308.8951863044144,2,2,3,7,2
313,51,48,4035.8407446393653,5,5,5,15,0
314,264,23,1822.3243193071503,2,3,2,7,2
315,283,20,4292.740097073617,2,2,5,9,2
316,27,13,4125.162601991917,5,2,5,12,1
317,226,47,401.80676460899997,2,5,1,8,2
318,277,44,2917.182686354312,2,5,3,10,1
319,286,41,3203.594528947773,2,5,4,11,1
320,97,32,14.27788053419809,4,4,1,9,2
321,284,26,4899.792410459184,2,3,5,10,1
322,317,14,2038.772198754547,1,2,3,6,3
323,304,36,2591.5425972374733,1,4,3,8,2
324,147,8,982.0723581671746,3,1,1,5,3
325,4,40,3058.4837018111334,5,4,4,13,0
326,35,22,4054.993132734001,5,3,5,13,0
327,192,22,2933.6028051414432,3,3,3,9,2
328,49,16,3942.294878552465,5,2,4,11,1
329,17,27,3658.228723983653,5,3,4,12,1
330,172,10,1195.9124795204189,3,1,2,6,3
331,220,25,2184.7060771346787,2,3,3,8,2
332,158,31,751.6481533376789,3,4,1,8,2
333,46,21,219.26001662475895,5,3,1,9,2
334,6,27,324.7140867680133,5,3,1,9,2
335,99,17,4713.074650065724,4,2,5,11,1
336,233,33,4922.841921080549,2,4,5,11,1
337,37,31,483.9377651687014,5,4,1,10,1
338,280,42,1682.615241508523,2,5,2,9,2
339,349,26,580.9591939785532,1,3,1,5,3
340,302,21,4172.8018286111555,1,3,5,9,2
341,181,36,2486.522487285006,3,4,3,10,1
342,95,1,3110.096162068491,4,1,4,9,2
343,99,4,2704.155220017681,4,1,3,8,2
344,188,4,3554.165383365173,3,1,4,8,2
345,116,26,1602.4698941521324,4,3,2,9,2
346,191,4,696.0918391048613,3,1,1,5,3
347,253,49,97.92381362127276,2,5,1,8,2
348,161,9,2234.007514243431,3,1,3,7,2
349,256,30,4540.093799669272,2,3,5,10,1
350,323,45,1533.2800246812108,1,5,2,8,2
351,128,4,987.8245374667591,4,1,1,6,3
352,18,5,4630.953303773064,5,1,5,11,1
353,281,45,536.1887073689579,2,5,1,8,2
354,223,23,268.48715674489245,2,3,1,6,3
355,54,16,4398.271743027635,5,2,5,12,1
356,58,22,3507.5378159538986,5,3,4,12,1
357,323,37,2116.1225043056897,1,4,3,8,2
358,360,8,3764.196425314117,1,1,4,6,3
359,174,48,3709.7853607009033,3,5,4,12,1
360,280,33,209.90221067030885,2,4,1,7,2
361,114,38,3384.471592188582,4,4,4,12,1
362,288,43,3207.953163489036,2,5,4,11,1
363,342,16,4819.257890717355,1,2,5,8,2
364,151,5,4833.44682469722,3,1,5,9,2
365,127,16,1895.2186377481992,4,2,2,8,2
366,155,7,2953.3111403222097,3,1,3,7,2
367,273,1,715.3733006930099,2,1,1,4,3
368,104,9,341.6180645260988,4,1,1,6,3
369,299,18,2169.571562571923,1,2,3,6,3
370,246,45,3452.511234066702,2,5,4,11,1
371,176,47,2843.128000265657,3,5,3,11,1
372,39,3,2153.9880417081495,5,1,3,9,2
373,170,24,4092.381608405209,3,3,5,11,1
374,247,28,3974.1930861968976,2,3,4,9,2
375,26,10,3662.390854838029,5,1,4,10,1
376,355,9,394.3909182872678,1,1,1,3,3
377,306,13,3984.3834431992614,1,2,4,7,2
378,13,48,4597.912366813553,5,5,5,15,0
379,316,35,306.6160205716731,1,4,1,6,3
380,313,23,2014.3402301545898,1,3,3,7,2
381,36,47,4941.893893685773,5,5,5,15,0
382,173,17,3000.201903756735,3,2,3,8,2
383,20,46,2572.7512366160395,5,5,3,13,0
384,321,7,895.4562758690303,1,1,1,3,3
385,264,16,2831.776553837508,2,2,3,7,2
386,142,40,2200.8258697425704,4,4,3,11,1
387,143,36,645.940847294914,4,4,1,9,2
388,92,20,2327.019936563991,4,2,3,9,2
389,354,24,830.3525328245497,1,3,1,5,3
390,322,47,3656.0114724130226,1,5,4,10,1
391,288,5,4868.505347056678,2,1,5,8,2
392,215,45,2353.189471644224,3,5,3,11,1
393,342,6,3165.517976253918,1,1,4,6,3
394,51,28,2160.567868586543,5,3,3,11,1
395,153,5,700.8847297484567,3,1,1,5,3
396,186,49,4853.070879512738,3,5,5,13,0
397,63,39,656.5975337795577,5,4,1,10,1
398,190,38,567.017774482568,3,4,1,8,2
399,125,2,2301.2729789397895,4,1,3,8,2
400,150,43,3297.8474561769913,3,5,4,12,1
401,314,39,1781.0671221547273,1,4,2,7,2
402,58,21,970.6599407625462,5,3,1,9,2
403,342,40,4096.627206457107,1,4,5,10,1
404,305,37,1821.8855698416605,1,4,2,7,2
405,180,18,979.6616571856969,3,2,1,6,3
406,170,48,1831.773538759282,3,5,2,10,1
407,326,46,1080.625496137527,1,5,2,8,2
408,271,12,2602.0442116835793,2,2,3,7,2
409,54,17,3344.764036827119,5,2,4,11,1
410,101,37,3999.791312223938,4,4,4,12,1
411,264,46,1145.5345312961308,2,5,2,9,2
412,53,38,843.1004884651832,5,4,1,10,1
413,60,15,107.82107026714858,5,2,1,8,2
414,108,7,1148.157964052741,4,1,2,7,2
415,5,14,129.28770896400323,5,2,1,8,2
416,103,1,1733.916276408406,4,1,2,7,2
417,196,38,737.0085132618827,3,4,1,8,2
418,262,3,2903.6790351566433,2,1,3,6,3
419,350,37,1924.7965298614529,1,4,2,7,2
420,47,44,476.99085194309015,5,5,1,11,1
421,355,31,2005.3336505526047,1,4,2,7,2
422,311,43,1054.6470986795796,1,5,2,8,2
423,308,13,3404.0849831871265,1,2,4,7,2
424,144,48,1828.536861405992,4,5,2,11,1
425,269,18,743.679745983579,2,2,1,5,3
426,124,17,1754.5126446973902,4,2,2,8,2
427,106,17,1129.6478863116256,4,2,2,8,2
428,158,11,3980.9372181755466,3,2,4,9,2
429,147,20,4917.004126221077,3,2,5,10,1
430,145,10,137.20203125853953,4,1,1,6,3
431,120,29,3453.2004852032564,4,3,4,11,1
432,319,48,1327.149589781198,1,5,2,8,2
433,275,34,341.37913290777936,2,4,1,7,2
434,92,17,81.61303483061464,4,2,1,7,2
435,58,42,4406.2382493700115,5,5,5,15,0
436,346,13,1774.4964453682196,1,2,2,5,3
437,229,44,4972.774021532115,2,5,5,12,1
438,117,47,2217.4620664747595,4,5,3,12,1
439,318,39,946.1127813391582,1,4,1,6,3
440,279,27,3887.9464069275036,2,3,4,9,2
441,127,26,4633.19615967282,4,3,5,12,1
442,129,28,4079.9489435697,4,3,5,12,1
443,58,13,3728.5441777973633,5,2,4,11,1
444,122,12,1680.1514756506508,4,2,2,8,2
445,1,44,331.8069158362631,5,5,1,11,1
446,239,28,1014.4837493148481,2,3,1,6,3
447,290,2,2239.583168694531,2,1,3,6,3
448,96,37,4781.437351371876,4,4,5,13,0
449,126,34,3617.042356580017,4,4,4,12,1
450,118,23,4143.132395389554,4,3,5,12,1
451,48,45,1393.696545563315,5,5,2,12,1
452,89,29,3422.276906992981,4,3,4,11,1
453,237,35,4313.566335456202,2,4,5,11,1
454,272,11,2402.2634593339567,2,2,3,7,2
455,189,48,2155.160382551486,3,5,3,11,1
456,192,33,3599.8285220245757,3,4,4,11,1
457,69,11,2803.959314361284,5,2,3,10,1
458,278,9,4965.923705138279,2,1,5,8,2
459,349,14,2131.2629756355227,1,2,3,6,3
460,247,9,887.9569538516831,2,1,1,4,3
461,76,39,2364.9559134037013,4,4,3,11,1
462,154,48,1183.6729155576795,3,5,2,10,1
463,144,3,2810.65656576456,4,1,3,8,2
464,86,29,637.7269922653497,4,3,1,8,2
465,185,19,4750.381605010438,3,2,5,10,1
466,285,36,4300.516178885403,2,4,5,11,1
467,220,32,786.2713315732633,2,4,1,7,2
468,69,7,870.2406845075783,5,1,1,7,2
469,47,28,2567.068985695202,5,3,3,11,1
470,94,44,3866.6781213382087,4,5,4,13,0
471,238,18,1103.205884980972,2,2,2,6,3
472,204,5,314.24888060206393,3,1,1,5,3
473,218,23,2732.2160401472493,2,3,3,8,2
474,341,22,3461.0695993690297,1,3,4,8,2
475,39,26,1229.3838015506578,5,3,2,10,1
476,100,42,3701.4412608756843,4,5,4,13,0
477,289,12,4753.712486873597,2,2,5,9,2
478,254,40,694.0014690005096,2,4,1,7,2
479,222,19,2560.0350358903897,2,2,3,7,2
480,357,47,293.64133390109714,1,5,1,7,2
481,23,1,1041.2384260812707,5,1,2,8,2
482,250,3,458.1985737707557,2,1,1,4,3
483,10,27,2025.9930491702105,5,3,3,11,1
484,246,18,4105.95063397004,2,2,5,9,2
485,325,30,2889.8809481036888,1,3,3,7,2
486,100,2,1120.6983374554995,4,1,2,7,2
487,290,5,210.15212900765823,2,1,1,4,3
488,180,29,2771.4569944808973,3,3,3,9,2
489,223,33,672.6556078029492,2,4,1,7,2
490,250,42,1720.2427965451486,2,5,2,9,2
491,147,20,2555.8593719788937,3,2,3,8,2
492,96,30,4519.6253530741005,4,3,5,12,1
493,257,42,418.2984021726977,2,5,1,8,2
494,325,5,3346.3518854114845,1,1,4,6,3
495,4,21,80.26561466934385,5,3,1,9,2
496,16,15,3153.243676277876,5,2,4,11,1
497,280,20,2762.1471217596622,2,2,3,7,2
498,336,8,4061.214434249438,1,1,5,7,2
499,247,49,2662.9957395937518,2,5,3,10,1
500,258,31,1769.556832633426,2,4,2,8,2
501,160,12,1221.3268479278506,3,2,2,7,2
502,340,21,435.3962114925443,1,3,1,5,3
503,152,30,2677.7172447391918,3,3,3,9,2
504,178,27,4442.7264139763565,3,3,5,11,1
505,163,44,2578.5750248388904,3,5,3,11,1
506,33,26,3698.123258754803,5,3,4,12,1
507,179,33,1499.1903417057022,3,4,2,9,2
508,101,26,2246.172990775091,4,3,3,10,1
509,268,26,1629.7699851951977,2,3,2,7,2
510,323,36,555.237895660938,1,4,1,6,3
511,65,40,2090.77313038469,5,4,3,12,1
512,168,1,3823.79328686771,3,1,4,8,2
513,330,15,1980.925247727141,1,2,2,5,3
514,43,1,3254.3943188691537,5,1,4,10,1
515,44,11,3795.4912654137925,5,2,4,11,1
516,285,2,1620.45377380945,2,1,2,5,3
517,12,1,3989.597652431329,5,1,4,10,1
518,95,31,1701.2393276788512,4,4,2,10,1
519,302,44,1287.9742316976758,1,5,2,8,2
520,253,16,1120.0063771217265,2,2,2,6,3
521,242,22,1007.521687166948,2,3,1,6,3
522,35,42,3688.24912333885,5,5,4,14,0
523,215,18,4438.6712126740185,3,2,5,10,1
524,337,47,1160.9358861845933,1,5,2,8,2
525,90,17,435.3490860028082,4,2,1,7,2
526,264,30,1575.6972116793077,2,3,2,7,2
527,93,10,3292.6577222175797,4,1,4,9,2
528,90,35,1848.915260207934,4,4,2,10,1
529,115,21,2750.3909306639816,4,3,3,10,1
530,105,16,3724.0817787192245,4,2,4,10,1
531,196,6,2048.307870463692,3,1,3,7,2
532,314,3,4998.477208542262,1,1,5,7,2
533,114,41,1496.7668085751575,4,5,2,11,1
534,75,43,4891.459275844359,4,5,5,14,0
535,217,21,1023.1180295132385,3,3,1,7,2
536,277,13,563.549398888806,2,2,1,5,3
537,249,18,3756.644819220896,2,2,4,8,2
538,164,24,3514.5251866894782,3,3,4,10,1
539,357,27,4057.7350427398974,1,3,5,9,2
540,192,4,1724.5162044491915,3,1,2,6,3
541,227,22,4654.730192726389,2,3,5,10,1
542,177,24,606.2123275816634,3,3,1,7,2
543,99,40,161.0827356423195,4,4,1,9,2
544,36,45,1509.8137867087378,5,5,2,12,1
545,96,10,3988.6490723672496,4,1,4,9,2
546,152,2,3368.1817132955043,3,1,4,8,2
547,151,40,2186.6817334708894,3,4,3,10,1
548,190,6,1288.705534829734,3,1,2,6,3
549,224,48,305.77120597220625,2,5,1,8,2
550,37,18,1694.1528364528879,5,2,2,9,2
551,268,17,2305.4986410962006,2,2,3,7,2
552,183,38,3438.2489519753144,3,4,4,11,1
553,13,45,3233.4000551826907,5,5,4,14,0
554,279,23,4737.251065630071,2,3,5,10,1
555,217,46,510.9756360737766,3,5,1,9,2
556,355,30,1688.3372131668907,1,3,2,6,3
557,361,21,2413.0746288651226,1,3,3,7,2
558,286,10,3356.7720113314062,2,1,4,7,2
559,273,43,2482.3039402926174,2,5,3,10,1
560,62,13,4564.663577414226,5,2,5,12,1
561,84,12,3047.2750045430694,4,2,4,10,1
562,217,9,207.93039435916404,3,1,1,5,3
563,342,4,577.14328564001,1,1,1,3,3
564,187,39,3769.942851787987,3,4,4,11,1
565,19,24,3581.7806047680083,5,3,4,12,1
566,177,34,775.9500391102687,3,4,1,8,2
567,100,39,303.9542187176736,4,4,1,9,2
568,233,41,2897.802098644944,2,5,3,10,1
569,76,5,3182.3367718134,4,1,4,9,2
570,265,15,685.1451911890463,2,2,1,5,3
571,284,4,2373.360411993668,2,1,3,6,3
572,206,39,1536.0993303008806,3,4,2,9,2
573,223,8,4657.215171728069,2,1,5,8,2
574,52,49,1103.807018913129,5,5,2,12,1
575,339,45,3668.971022257465,1,5,4,10,1
576,144,24,2595.4882275882446,4,3,3,10,1
577,69,28,67.4898500099565,5,3,1,9,2
578,99,43,2589.8229302309624,4,5,3,12,1
579,25,27,506.3660280983124,5,3,1,9,2
580,53,1,3298.7203571683053,5,1,4,10,1
581,151,34,2831.9624166040453,3,4,3,10,1
582,144,17,62.03186439403808,4,2,1,7,2
583,57,37,1031.4172196190766,5,4,2,11,1
584,39,38,3883.3630138313933,5,4,4,13,0
585,109,26,1386.1053453670856,4,3,2,9,2
586,181,24,2501.424171803635,3,3,3,9,2
587,42,39,1566.873085901827,5,4,2,11,1
588,186,21,4608.419013423724,3,3,5,11,1
589,223,30,2687.5193187393365,2,3,3,8,2
590,122,47,3483.905839131544,4,5,4,13,0
591,133,48,426.54576243856883,4,5,1,10,1
592,163,13,211.27657778843317,3,2,1,6,3
593,215,37,1303.5486933849832,3,4,2,9,2
594,221,3,1552.5801183457338,2,1,2,5,3
595,235,32,3441.5259004877103,2,4,4,10,1
596,331,35,2849.961208535082,1,4,3,8,2
597,146,19,1879.1522386055765,4,2,2,8,2
598,239,14,3274.046246048274,2,2,4,8,2
599,76,48,826.1930792080728,4,5,1,10,1
600,9,22,326.81357712538244,5,3,1,9,2
601,74,17,4273.98041066782,4,2,5,11,1
602,253,4,2824.091180061699,2,1,3,6,3
603,230,45,3248.985415450732,2,5,4,11,1
604,7,40,1543.1388312403749,5,4,2,11,1
605,174,19,1866.0552391111216,3,2,2,7,2
606,141,37,421.01356129334886,4,4,1,9,2
607,168,2,4286.371057130849,3,1,5,9,2
608,170,15,2966.2728558938848,3,2,3,8,2
609,283,2,427.30203926790375,2,1,1,4,3
610,122,11,4024.602702627753,4,2,5,11,1
611,194,45,2226.135693889703,3,5,3,11,1
612,5,23,3827.855737348366,5,3,4,12,1
613,29,10,72.97311182484853,5,1,1,7,2
614,165,3,153.411087890892,3,1,1,5,3
615,339,5,862.2069643229019,1,1,1,3,3
616,136,3,1062.4736151419925,4,1,2,7,2
617,321,38,3822.1380962475873,1,4,4,9,2
618,342,13,3536.403878442825,1,2,4,7,2
619,145,42,3084.2797144578426,4,5,4,13,0
620,327,19,4425.445893451861,1,2,5,8,2
621,217,40,1243.2724304452677,3,4,2,9,2
622,301,35,4522.980470483197,1,4,5,10,1
623,132,24,4548.26063563326,4,3,5,12,1
624,292,24,2176.956203332451,1,3,3,7,2
625,70,17,480.9871400966427,5,2,1,8,2
626,252,40,3635.5339418657295,2,4,4,10,1
627,275,10,1691.274076508925,2,1,2,5,3
628,364,2,3976.698292009286,1,1,4,6,3
629,182,44,826.8145166799776,3,5,1,9,2
630,167,23,2702.180416736083,3,3,3,9,2
631,91,6,2545.2879142878724,4,1,3,8,2
632,202,2,510.5693079423714,3,1,1,5,3
633,346,21,1823.0308001065657,1,3,2,6,3
634,19,35,432.92901409917295,5,4,1,10,1
635,39,49,2329.054144466115,5,5,3,13,0
636,126,29,4216.093747482826,4,3,5,12,1
637,173,7,1358.321768887617,3,1,2,6,3
638,141,29,3826.661316065313,4,3,4,11,1
639,242,37,925.3028039061571,2,4,1,7,2
640,220,23,3371.9372881783506,2,3,4,9,2
641,126,33,4578.531625652943,4,4,5,13,0
642,58,8,1626.4011270131914,5,1,2,8,2
643,148,12,4503.054074062205,3,2,5,10,1
644,317,46,2532.0504233667084,1,5,3,9,2
645,361,48,1590.857614496631,1,5,2,8,2
646,1,10,4483.576093206542,5,1,5,11,1
647,348,15,169.8659611809436,1,2,1,4,3
648,190,24,149.81406785132415,3,3,1,7,2
649,191,26,3003.149724989601,3,3,3,9,2
650,312,47,3985.786079477869,1,5,4,10,1
651,117,42,3760.21607411615,4,5,4,13,0
652,134,39,406.55282172451155,4,4,1,9,2
653,58,3,4751.753455732453,5,1,5,11,1
654,44,2,3518.287052811203,5,1,4,10,1
655,173,6,4746.069148101417,3,1,5,9,2
656,160,21,1652.1978172807694,3,3,2,8,2
657,173,9,3472.756248634259,3,1,4,8,2
658,317,10,4301.094346200091,1,1,5,7,2
659,303,36,1908.5164735399235,1,4,2,7,2
660,149,3,4824.650994655165,3,1,5,9,2
661,80,41,1332.3140281904996,4,5,2,11,1
662,213,24,1584.9119938458912,3,3,2,8,2
663,203,22,4602.439597368923,3,3,5,11,1
664,252,49,4848.602135048489,2,5,5,12,1
665,229,14,1433.126784042697,2,2,2,6,3
666,164,42,690.5862978178636,3,5,1,9,2
667,227,45,3797.686494455882,2,5,4,11,1
668,147,44,4649.029678839237,3,5,5,13,0
669,20,27,3007.5610820723546,5,3,3,11,1
670,47,33,3176.249582487171,5,4,4,13,0
671,233,22,3817.0872375197782,2,3,4,9,2
672,305,29,773.8932460186271,1,3,1,5,3
673,14,19,4867.609793508749,5,2,5,12,1
674,143,19,1828.0036297956879,4,2,2,8,2
675,1,6,3144.9197254518904,5,1,4,10,1
676,54,45,2348.3939422949643,5,5,3,13,0
677,259,19,2346.2230890265764,2,2,3,7,2
678,144,13,3516.69441687741,4,2,4,10,1
679,12,26,4973.36487137255,5,3,5,13,0
680,330,22,3298.708653974798,1,3,4,8,2
681,224,21,3972.355066547949,2,3,4,9,2
682,272,36,147.80412573872792,2,4,1,7,2
683,358,2,4054.0325716334432,1,1,5,7,2
684,156,47,1506.8796500238027,3,5,2,10,1
685,8,44,642.2422067229777,5,5,1,11,1
686,122,30,575.5370863840521,4,3,1,8,2
687,348,27,3402.5753227064374,1,3,4,8,2
688,164,7,4988.108011842344,3,1,5,9,2
689,90,20,3334.3135408807693,4,2,4,10,1
690,136,31,1319.1172688332108,4,4,2,10,1
691,186,23,1024.496795304669,3,3,1,7,2
692,316,13,2634.525925347523,1,2,3,6,3
693,178,17,334.54610376000943,3,2,1,6,3
694,28,4,2002.660856306664,5,1,2,8,2
695,220,14,3334.5121709888795,2,2,4,8,2
696,357,20,4838.634756284336,1,2,5,8,2
697,41,13,2134.01070459987,5,2,3,10,1
698,228,3,1009.11746263246,2,1,1,4,3
699,192,26,4088.638392830194,3,3,5,11,1
700,145,26,3723.555629054476,4,3,4,11,1
701,201,18,4299.922402141672,3,2,5,10,1
702,212,32,1081.4464504390317,3,4,2,9,2
703,220,14,2030.1126572906771,2,2,3,7,2
704,240,47,4907.956644237957,2,5,5,12,1
705,46,3,798.6311756841038,5,1,1,7,2
706,35,1,3360.5395875856348,5,1,4,10,1
707,253,26,1193.5504631208476,2,3,2,7,2
708,82,24,2505.793441349896,4,3,3,10,1
709,256,49,4004.5431325204827,2,5,4,11,1
710,197,35,2448.0444022535366,3,4,3,10,1
711,303,14,4029.3536496264314,1,2,5,8,2
712,10,3,2137.411178147326,5,1,3,9,2
713,312,13,4996.771120051464,1,2,5,8,2
714,286,47,2184.7828887588485,2,5,3,10,1
715,242,14,755.4035984027538,2,2,1,5,3
716,251,21,2015.328883089752,2,3,3,8,2
717,5,26,3715.5399913647284,5,3,4,12,1
718,119,3,4241.209411215556,4,1,5,10,1
719,289,40,2305.915462889549,2,4,3,9,2
720,65,4,2976.439436881614,5,1,3,9,2
721,146,36,4226.001438453189,4,4,5,13,0
722,224,43,4069.595438191616,2,5,5,12,1
723,239,1,3292.0422877520527,2,1,4,7,2
724,177,40,4076.985250211766,3,4,5,12,1
725,267,47,2883.794684259499,2,5,3,10,1
726,341,33,33.19436293715039,1,4,1,6,3
727,282,7,215.92125416709376,2,1,1,4,3
728,63,11,4899.2439121985335,5,2,5,12,1
729,217,27,733.510289593499,3,3,1,7,2
730,342,14,2028.5368800290792,1,2,3,6,3
731,315,22,4669.71826229974,1,3,5,9,2
732,283,16,983.2470288179167,2,2,1,5,3
733,177,46,4220.5188088878385,3,5,5,13,0
734,98,12,4093.1551651163563,4,2,5,11,1
735,105,49,4931.7849762111855,4,5,5,14,0
736,99,46,1415.59234990436,4,5,2,11,1
737,311,10,1583.4735233469282,1,1,2,4,3
738,6,24,4515.361225278354,5,3,5,13,0
739,197,46,1178.0545054193751,3,5,2,10,1
740,351,18,2744.0257753656742,1,2,3,6,3
741,133,22,3539.6513463633705,4,3,4,11,1
742,358,9,1366.7023838617995,1,1,2,4,3
743,259,17,4692.680597769347,2,2,5,9,2
744,23,38,3331.8307648888626,5,4,4,13,0
745,53,40,245.22514826642697,5,4,1,10,1
746,165,13,687.3302809919605,3,2,1,6,3
747,202,37,962.0000347569023,3,4,1,8,2
748,83,6,1232.337246327314,4,1,2,7,2
749,145,21,3656.0800764468877,4,3,4,11,1
750,85,36,453.7868713297858,4,4,1,9,2
751,78,7,1759.4674146579111,4,1,2,7,2
752,1,36,4557.802783406728,5,4,5,14,0
753,51,25,2787.77175482165,5,3,3,11,1
754,173,11,1334.8278535542931,3,2,2,7,2
755,205,44,4785.710919436747,3,5,5,13,0
756,260,14,1229.1363009237252,2,2,2,6,3
757,288,45,4526.447110125538,2,5,5,12,1
758,34,29,3631.590671336632,5,3,4,12,1
759,348,10,3705.1999744243426,1,1,4,6,3
760,95,48,3827.0471988240643,4,5,4,13,0
761,72,5,2537.780867165474,5,1,3,9,2
762,39,8,4074.7478427533174,5,1,5,11,1
763,154,46,4182.603557784926,3,5,5,13,0
764,250,5,1808.8287411638241,2,1,2,5,3
765,162,24,2007.7191458997127,3,3,2,8,2
766,118,40,4444.896025509739,4,4,5,13,0
767,259,26,2628.399009543326,2,3,3,8,2
768,306,6,4336.048044749927,1,1,5,7,2
769,268,16,3137.5796141714586,2,2,4,8,2
770,54,36,2971.9031061777214,5,4,3,12,1
771,236,12,164.59495685653076,2,2,1,5,3
772,222,11,1396.6930452253414,2,2,2,6,3
773,251,3,2515.2676580425673,2,1,3,6,3
774,313,44,2940.7126889521574,1,5,3,9,2
775,112,37,3155.8682997136634,4,4,4,12,1
776,255,6,3583.951896807969,2,1,4,7,2
777,303,19,3284.6048271452228,1,2,4,7,2
778,207,18,4244.397769905044,3,2,5,10,1
779,229,16,1484.3970110086918,2,2,2,6,3
780,341,23,3211.434228472803,1,3,4,8,2
781,66,43,265.28597583939376,5,5,1,11,1
782,75,37,2406.148485836919,4,4,3,11,1
783,103,9,1347.4845000999437,4,1,2,7,2
784,192,3,1910.6268699905334,3,1,2,6,3
785,252,8,1779.767131307146,2,1,2,5,3
786,226,38,311.54907899166227,2,4,1,7,2
787,294,4,2338.562545749364,1,1,3,5,3
788,306,12,4973.200147077851,1,2,5,8,2
789,98,44,1501.6909236140532,4,5,2,11,1
790,338,31,3683.368398624571,1,4,4,9,2
791,286,25,2743.463791252974,2,3,3,8,2
792,335,16,1632.8742496520538,1,2,2,5,3
793,347,42,457.13923135818163,1,5,1,7,2
794,308,14,1087.1309248184098,1,2,2,5,3
795,249,13,3911.449162056317,2,2,4,8,2
796,166,41,1402.3106853190404,3,5,2,10,1
797,335,7,730.0693872351474,1,1,1,3,3
798,30,12,1663.1787188987587,5,2,2,9,2
799,247,37,2924.374331616174,2,4,3,9,2
800,106,4,3520.2811898070954,4,1,4,9,2
801,51,2,1942.9505364782042,5,1,2,8,2
802,81,35,2495.7543138209617,4,4,3,11,1
803,133,44,2280.034293246973,4,5,3,12,1
804,285,3,54.926716117900156,2,1,1,4,3
805,138,4,1984.0463695306828,4,1,2,7,2
806,184,38,2940.725852758689,3,4,3,10,1
807,330,12,2854.0241349146477,1,2,3,6,3
808,273,19,3751.3401160878916,2,2,4,8,2
809,340,10,3355.17579307234,1,1,4,6,3
810,69,1,1391.2659176096072,5,1,2,8,2
811,34,17,1285.6619210792235,5,2,2,9,2
812,262,16,2326.067572336536,2,2,3,7,2
813,53,9,3667.5186419310576,5,1,4,10,1
814,205,9,478.1982598140623,3,1,1,5,3
815,126,9,4742.14964935045,4,1,5,10,1
816,235,12,2720.334087295094,2,2,3,7,2
817,43,41,1538.9778907181685,5,5,2,12,1
818,240,15,3470.0222420983155,2,2,4,8,2
819,111,2,233.18182305307792,4,1,1,6,3
820,249,11,2427.1406097574836,2,2,3,7,2
821,151,11,2434.988540844407,3,2,3,8,2
822,183,8,818.256671697658,3,1,1,5,3
823,336,32,4188.565201549997,1,4,5,10,1
824,95,6,3986.092472214468,4,1,4,9,2
825,8,20,772.1346483240079,5,2,1,8,2
826,360,39,1825.4981948812538,1,4,2,7,2
827,184,35,511.14348758813077,3,4,1,8,2
828,281,8,4244.557696627592,2,1,5,8,2
829,195,49,1623.3673177057178,3,5,2,10,1
830,352,43,2202.1883762096872,1,5,3,9,2
831,195,34,1626.1210306026267,3,4,2,9,2
832,155,19,1557.0298221601054,3,2,2,7,2
833,93,7,3739.0382462054595,4,1,4,9,2
834,160,31,3740.3555085573175,3,4,4,11,1
835,61,18,2593.7629706980415,5,2,3,10,1
836,122,40,3291.5085771383083,4,4,4,12,1
837,51,14,2563.1993548162036,5,2,3,10,1
838,277,39,152.660157599178,2,4,1,7,2
839,5,36,339.3721013183631,5,4,1,10,1
840,92,17,1924.8654418690282,4,2,2,8,2
841,170,37,3751.234329555687,3,4,4,11,1
842,317,44,4566.998878390381,1,5,5,11,1
843,22,9,158.24444368029555,5,1,1,7,2
844,326,20,1846.469962907167,1,2,2,5,3
845,1,45,1126.6743562208903,5,5,2,12,1
846,133,28,4077.874353015655,4,3,5,12,1
847,233,20,4231.381041826659,2,2,5,9,2
848,12,41,1039.9802497825574,5,5,2,12,1
849,346,36,3557.0279946400124,1,4,4,9,2
850,46,27,3661.4626261341286,5,3,4,12,1
851,34,8,893.517906945026,5,1,1,7,2
852,78,32,2174.1426258710962,4,4,3,11,1
853,218,1,3105.48564916456,2,1,4,7,2
854,301,17,140.07236859366841,1,2,1,4,3
855,73,9,2028.9132468989549,5,1,3,9,2
856,282,20,783.2415824086272,2,2,1,5,3
857,249,45,2714.0635405932276,2,5,3,10,1
858,47,32,4216.1587414701635,5,4,5,14,0
859,121,2,2628.522153743926,4,1,3,8,2
860,214,32,189.55814508133298,3,4,1,8,2
861,239,45,157.98965552798794,2,5,1,8,2
862,56,9,3031.460698061705,5,1,3,9,2
863,350,30,1646.6279770428064,1,3,2,6,3
864,107,20,2867.6058523247443,4,2,3,9,2
865,319,38,826.5491734907781,1,4,1,6,3
866,48,1,3886.543140652198,5,1,4,10,1
867,61,5,4304.991331610503,5,1,5,11,1
868,337,35,4447.2357544036195,1,4,5,10,1
869,26,36,1527.3321982684429,5,4,2,11,1
870,292,1,3307.0694844474115,1,1,4,6,3
871,257,14,1402.4215117799984,2,2,2,6,3
872,8,9,3816.1565358497764,5,1,4,10,1
873,113,30,611.4197611093546,4,3,1,8,2
874,355,24,3816.1964074945945,1,3,4,8,2
875,253,4,2204.2459019410385,2,1,3,6,3
876,180,14,4279.191957273285,3,2,5,10,1
877,207,25,3697.264991330871,3,3,4,10,1
878,303,4,1888.8330070754598,1,1,2,4,3
879,127,25,4518.660534948658,4,3,5,12,1
880,56,10,1423.8523249837986,5,1,2,8,2
881,214,35,4835.2732708652575,3,4,5,12,1
882,14,7,3838.344885938865,5,1,4,10,1
883,28,42,4953.467507843235,5,5,5,15,0
884,78,13,278.98403582840297,4,2,1,7,2
885,216,4,1377.4398689268828,3,1,2,6,3
886,154,43,3708.9086400072215,3,5,4,12,1
887,14,36,4612.026009239373,5,4,5,14,0
888,187,14,153.56637742607023,3,2,1,6,3
889,312,18,10.046386918167874,1,2,1,4,3
890,7,8,1288.6507199886762,5,1,2,8,2
891,3,32,4265.365596391492,5,4,5,14,0
892,111,27,3838.0939796946927,4,3,4,11,1
893,238,42,1707.9845362225965,2,5,2,9,2
894,363,37,20.036209083724383,1,4,1,6,3
895,239,23,2777.9816473590986,2,3,3,8,2
896,274,7,1197.3978025402448,2,1,2,5,3
897,294,12,3730.5885532142197,1,2,4,7,2
898,227,25,2237.284825269304,2,3,3,8,2
899,15,3,3396.2235960078588,5,1,4,10,1
900,192,26,4263.021061142568,3,3,5,11,1
901,119,4,2683.4413995973314,4,1,3,8,2
902,28,42,1686.418148234179,5,5,2,12,1
903,202,36,3850.0222946160925,3,4,4,11,1
904,39,15,1333.2843264581775,5,2,2,9,2
905,273,32,4458.6788923711065,2,4,5,11,1
906,231,29,366.4239571973495,2,3,1,6,3
907,86,10,4178.988519131638,4,1,5,10,1
908,126,21,466.86307908204583,4,3,1,8,2
909,300,16,290.12353224498054,1,2,1,4,3
910,25,47,1822.652117367323,5,5,2,12,1
911,145,19,4783.181278829392,4,2,5,11,1
912,13,29,4917.595410416095,5,3,5,13,0
913,212,18,1018.331799821135,3,2,1,6,3
914,25,44,751.7014027537101,5,5,1,11,1
915,68,16,1771.2371244583403,5,2,2,9,2
916,67,1,1692.0633359965582,5,1,2,8,2
917,233,48,3800.368484862493,2,5,4,11,1
918,109,2,2225.5551135261635,4,1,3,8,2
919,146,15,3901.6190928152214,4,2,4,10,1
920,111,39,3746.0783541549786,4,4,4,12,1
921,228,28,2895.7690463283575,2,3,3,8,2
922,111,1,4169.225377710859,4,1,5,10,1
923,34,5,986.2822552980085,5,1,1,7,2
924,111,42,817.4343733459614,4,5,1,10,1
925,264,22,3755.7447899283143,2,3,4,9,2
926,236,36,1231.5373401549246,2,4,2,8,2
927,83,46,23.943975263719455,4,5,1,10,1
928,42,13,4560.681241536246,5,2,5,12,1
929,101,1,3118.455919584984,4,1,4,9,2
930,6,16,2230.2391130596243,5,2,3,10,1
931,180,41,3631.425184945099,3,5,4,12,1
932,282,22,1673.3253482452765,2,3,2,7,2
933,320,32,4768.793624906135,1,4,5,10,1
934,226,16,352.4152418475804,2,2,1,5,3
935,315,15,3208.331471405181,1,2,4,7,2
936,229,46,3888.674519477755,2,5,4,11,1
937,289,42,2350.938280388612,2,5,3,10,1
938,150,12,3777.292091779519,3,2,4,9,2
939,277,1,4635.282885414061,2,1,5,8,2
940,198,17,3722.5295643896297,3,2,4,9,2
941,70,41,1553.7406670101925,5,5,2,12,1
942,112,28,2813.6134098488205,4,3,3,10,1
943,4,7,4558.90155411952,5,1,5,11,1
944,350,9,2250.997650157639,1,1,3,5,3
945,331,22,3411.6754896294174,1,3,4,8,2
946,318,26,2332.9184783930737,1,3,3,7,2
947,350,12,615.5073431324072,1,2,1,4,3
948,95,7,302.40220302261326,4,1,1,6,3
949,152,46,4761.84705854715,3,5,5,13,0
950,311,47,3066.5834493712673,1,5,4,10,1
951,137,15,528.036416481233,4,2,1,7,2
952,247,38,4288.618406764492,2,4,5,11,1
953,243,21,2618.2387511889583,2,3,3,8,2
954,31,14,3861.9412400769675,5,2,4,11,1
955,40,2,642.5134161708212,5,1,1,7,2
956,229,8,4535.483054829635,2,1,5,8,2
957,36,45,2956.7718440133076,5,5,3,13,0
958,223,6,3693.920796937715,2,1,4,7,2
959,6,37,166.58464320409638,5,4,1,10,1
960,322,37,1583.3714519930256,1,4,2,7,2
961,220,33,1344.5526178331043,2,4,2,8,2
962,75,41,4748.479026486475,4,5,5,14,0
963,4,6,934.839458712877,5,1,1,7,2
964,335,26,3538.1881163033217,1,3,4,8,2
965,134,39,223.34015336897218,4,4,1,9,2
966,118,41,996.4435876142504,4,5,1,10,1
967,94,37,1699.6007977292204,4,4,2,10,1
968,62,14,3974.584180894961,5,2,4,11,1
969,194,37,3951.983134508384,3,4,4,11,1
970,335,8,4763.483290098377,1,1,5,7,2
971,203,39,4584.669838307755,3,4,5,12,1
972,26,13,416.75782927463155,5,2,1,8,2
973,173,13,4151.039933502032,3,2,5,10,1
974,300,40,2261.3561619046836,1,4,3,8,2
975,133,43,4330.77159274137,4,5,5,14,0
976,326,28,455.53839514034155,1,3,1,5,3
977,118,18,4115.617816521605,4,2,5,11,1
978,324,19,806.6161698138638,1,2,1,4,3
979,275,38,1675.8697340460176,2,4,2,8,2
980,212,32,153.95351744720813,3,4,1,8,2
981,225,22,627.4031600538214,2,3,1,6,3
982,20,2,2234.1721682077896,5,1,3,9,2
983,113,13,4093.508294816007,4,2,5,11,1
984,140,23,3870.6121591115984,4,3,4,11,1
985,47,25,1184.135831263803,5,3,2,10,1
986,1,28,766.9353408557121,5,3,1,9,2
987,90,11,1952.4246802790326,4,2,2,8,2
988,142,33,4417.509052592295,4,4,5,13,0
989,320,24,466.21112007338576,1,3,1,5,3
990,38,2,2719.1409116183077,5,1,3,9,2
991,293,30,453.1493222211791,1,3,1,5,3
992,139,17,2356.3584846095523,4,2,3,9,2
993,356,40,642.6896456833016,1,4,1,6,3
994,333,34,410.8813056468303,1,4,1,6,3
995,259,38,962.338171987288,2,4,1,7,2
996,161,22,1283.7275366501433,3,3,2,8,2
997,178,5,1388.5642418658097,3,1,2,6,3
998,10,48,3229.8870567641907,5,5,4,14,0
999,261,40,284.3595593581775,2,4,1,7,2
1000,138,16,413.237208927767,4,2,1,7,2
1001,172,13,951.6437457815429,3,2,1,6,3
1002,13,26,4361.594715215296,5,3,5,13,0
1003,168,31,3146.7385810555315,3,4,4,11,1
1004,130,39,3654.5445993478984,4,4,4,12,1
1005,84,48,1858.1071562327193,4,5,2,11,1
1006,321,23,1073.9695418593044,1,3,2,6,3
1007,319,48,199.4271912049349,1,5,1,7,2
1008,101,12,2447.792743659742,4,2,3,9,2
1009,329,14,2875.662011494291,1,2,3,6,3
1010,273,18,4486.043943944782,2,2,5,9,2
1011,265,27,4411.64396395748,2,3,5,10,1
1012,38,28,2129.1789407765523,5,3,3,11,1
1013,94,18,2123.6538657272763,4,2,3,9,2
1014,95,16,814.0032546120101,4,2,1,7,2
1015,305,16,1294.6704493345283,1,2,2,5,3
1016,69,13,4629.061245841249,5,2,5,12,1
1017,318,29,713.7696945666586,1,3,1,5,3
1018,236,9,4843.8107382508215,2,1,5,8,2
1019,334,26,2528.64536557383,1,3,3,7,2
1020,137,28,2288.467806086487,4,3,3,10,1
1021,76,41,881.445519624909,4,5,1,10,1
1022,35,13,3311.0908399075793,5,2,4,11,1
1023,1,36,2304.629136627617,5,4,3,12,1
1024,296,9,1859.608708886974,1,1,2,4,3
1025,320,47,1329.9359307406069,1,5,2,8,2
1026,60,14,341.76914704421114,5,2,1,8,2
1027,320,12,2601.447301589968,1,2,3,6,3
1028,349,32,1571.4125819625974,1,4,2,7,2
1029,328,38,3542.2473629838328,1,4,4,9,2
1030,267,3,3620.3765601782707,2,1,4,7,2
1031,361,16,1667.213987573604,1,2,2,5,3
1032,229,20,3348.9122109981367,2,2,4,8,2
1033,270,32,1300.7894489946766,2,4,2,8,2
1034,316,23,3638.596893948343,1,3,4,8,2
1035,286,17,90.22495627065774,2,2,1,5,3
1036,291,16,766.5277472567108,2,2,1,5,3
1037,213,38,1232.5932229181067,3,4,2,9,2
1038,165,8,3866.948080062667,3,1,4,8,2
1039,5,19,341.2175028911986,5,2,1,8,2
1040,339,30,948.4051471404995,1,3,1,5,3
1041,78,34,1799.5342864709185,4,4,2,10,1
1042,62,14,55.78322082302538,5,2,1,8,2
1043,132,22,3812.983667118299,4,3,4,11,1
1044,89,44,2804.9246968639513,4,5,3,12,1
1045,237,17,4504.3901412298865,2,2,5,9,2
1046,42,15,164.84485239927773,5,2,1,8,2
1047,89,48,1364.239511993938,4,5,2,11,1
1048,296,32,3658.945770609144,1,4,4,9,2
1049,328,13,3378.9956030503827,1,2,4,7,2
1050,295,21,1222.8566286174926,1,3,2,6,3
1051,104,49,2982.48179749063,4,5,3,12,1
1052,14,40,3970.850689007691,5,4,4,13,0
1053,288,33,176.56970963972753,2,4,1,7,2
1054,179,27,3590.96570037838,3,3,4,10,1
1055,125,35,1267.964354918738,4,4,2,10,1
1056,353,16,4739.77792978532,1,2,5,8,2
1057,23,28,2695.718904591931,5,3,3,11,1
1058,63,34,176.59705133009282,5,4,1,10,1
1059,143,47,2023.1187877249508,4,5,3,12,1
1060,153,1,4831.896172515234,3,1,5,9,2
1061,145,41,3654.561236288626,4,5,4,13,0
1062,225,48,1509.3902283954462,2,5,2,9,2
1063,309,31,2880.5837986261927,1,4,3,8,2
1064,104,36,2999.5157645417853,4,4,3,11,1
1065,104,44,126.50732230821903,4,5,1,10,1
1066,39,33,902.3784726336178,5,4,1,10,1
1067,198,33,2763.366922178017,3,4,3,10,1
1068,134,39,2019.7352668685382,4,4,3,11,1
1069,67,18,958.2886944556022,5,2,1,8,2
1070,179,23,3865.6169869722075,3,3,4,10,1
1071,42,23,2450.0844545870254,5,3,3,11,1
1072,15,15,1556.7659804105772,5,2,2,9,2
1073,111,26,816.7699586145723,4,3,1,8,2
1074,157,30,3059.705180330238,3,3,4,10,1
1075,289,25,3334.6439002802404,2,3,4,9,2
1076,231,45,3351.2901107197054,2,5,4,11,1
1077,157,16,1109.2339278406268,3,2,2,7,2
1078,38,39,2980.738652039537,5,4,3,12,1
1079,97,48,4527.978259643553,4,5,5,14,0
1080,289,45,1772.4061278073077,2,5,2,9,2
1081,254,14,1061.726993882802,2,2,2,6,3
1082,196,17,3863.026084943602,3,2,4,9,2
1083,86,12,892.6458713956624,4,2,1,7,2
1084,322,29,1276.2061147705108,1,3,2,6,3
1085,10,32,512.2155276166927,5,4,1,10,1
1086,5,24,1346.6928372125997,5,3,2,10,1
1087,123,13,2057.571980412742,4,2,3,9,2
1088,330,20,330.14773109552567,1,2,1,4,3
1089,353,15,4359.82746537753,1,2,5,8,2
1090,118,4,2573.2372131612615,4,1,3,8,2
1091,294,34,2944.6371231237667,1,4,3,8,2
1092,159,28,1862.7159246029375,3,3,2,8,2
1093,303,2,3352.4777954740202,1,1,4,6,3
1094,228,47,2164.590861896643,2,5,3,10,1
1095,216,30,3808.9557349508323,3,3,4,10,1
1096,184,26,4108.7966961418815,3,3,5,11,1
1097,15,47,3362.5270683137487,5,5,4,14,0
1098,157,26,2461.7647396794105,3,3,3,9,2
1099,136,20,3913.524059505116,4,2,4,10,1
1100,261,42,2476.483703910197,2,5,3,10,1
1101,157,28,566.4344228041481,3,3,1,7,2
1102,47,20,590.53771398809,5,2,1,8,2
1103,324,11,4743.429866768676,1,2,5,8,2
1104,332,10,1075.6794122048018,1,1,2,4,3
1105,173,23,4081.465705199662,3,3,5,11,1
1106,130,37,1241.0599823023924,4,4,2,10,1
1107,95,41,2159.5926683455136,4,5,3,12,1
1108,115,19,3278.191079369739,4,2,4,10,1
1109,243,45,802.7471927505616,2,5,1,8,2
1110,292,18,3688.859976935749,1,2,4,7,2
1111,282,49,3452.665733057126,2,5,4,11,1
1112,299,27,2719.983616637857,1,3,3,7,2
1113,283,6,2833.7898826517376,2,1,3,6,3
1114,69,10,537.801249672736,5,1,1,7,2
1115,148,2,2185.38626067126,3,1,3,7,2
1116,11,24,441.9912628345467,5,3,1,9,2
1117,254,38,1546.237822257218,2,4,2,8,2
1118,330,28,4502.557584042262,1,3,5,9,2
1119,360,28,2876.9216687684125,1,3,3,7,2
1120,38,45,3716.090156381881,5,5,4,14,0
1121,134,39,2873.6904782057027,4,4,3,11,1
1122,200,2,979.2414224531789,3,1,1,5,3
1123,23,46,2978.0934957416584,5,5,3,13,0
1124,303,5,3779.3865057545695,1,1,4,6,3
1125,346,11,700.6409643064673,1,2,1,4,3
1126,302,10,4086.364483371978,1,1,5,7,2
1127,363,43,2781.406973101696,1,5,3,9,2
1128,218,2,31.33325882221869,2,1,1,4,3
1129,141,15,2603.694646826505,4,2,3,9,2
1130,104,39,1984.4007457627797,4,4,2,10,1
1131,210,41,1489.268091337038,3,5,2,10,1
1132,111,37,3858.5735273901973,4,4,4,12,1
1133,104,7,4498.504419457666,4,1,5,10,1
1134,316,20,3815.6389158321,1,2,4,7,2
1135,171,34,4235.395182138457,3,4,5,12,1
1136,356,35,4544.816906623754,1,4,5,10,1
1137,324,34,4564.020263768624,1,4,5,10,1
1138,133,22,582.0443335538197,4,3,1,8,2
1139,293,31,2287.3635895469356,1,4,3,8,2
1140,328,23,11.42950722062238,1,3,1,5,3
1141,127,19,2537.248297671326,4,2,3,9,2
1142,106,4,4621.977232375516,4,1,5,10,1
1143,92,24,1003.5204290868852,4,3,1,8,2
1144,287,20,3202.5352775452325,2,2,4,8,2
1145,51,39,3225.4514416252896,5,4,4,13,0
1146,29,28,810.166383591987,5,3,1,9,2
1147,296,39,1200.251922194127,1,4,2,7,2
1148,297,17,2315.488701961603,1,2,3,6,3
1149,214,19,949.1647885071837,3,2,1,6,3
1150,267,48,2929.1199528373004,2,5,3,10,1
1151,257,35,2427.8632378011225,2,4,3,9,2
1152,302,32,2600.798910776742,1,4,3,8,2
1153,101,47,680.9930885745706,4,5,1,10,1
1154,346,46,2591.086608938831,1,5,3,9,2
1155,110,47,256.89617336015516,4,5,1,10,1
1156,182,46,4408.861137078291,3,5,5,13,0
1157,313,39,1722.8159571199062,1,4,2,7,2
1158,1,35,4283.12325093018,5,4,5,14,0
1159,319,30,3511.2652800367705,1,3,4,8,2
1160,55,17,3833.201220592933,5,2,4,11,1
1161,149,42,1579.5770277492245,3,5,2,10,1
1162,309,47,1146.4422597719354,1,5,2,8,2
1163,137,29,2039.6353636671631,4,3,3,10,1
1164,202,6,130.88705343986868,3,1,1,5,3
1165,313,17,4594.5908275730635,1,2,5,8,2
1166,117,17,1941.2011871709615,4,2,2,8,2
1167,154,14,4942.897458169389,3,2,5,10,1
1168,291,24,3809.63260982899,2,3,4,9,2
1169,63,37,411.7698988985593,5,4,1,10,1
1170,244,40,3304.339506434454,2,4,4,10,1
1171,25,39,1361.487432541396,5,4,2,11,1
1172,90,32,1226.1560414510868,4,4,2,10,1
1173,75,36,1290.2477228170321,4,4,2,10,1
1174,294,37,4581.214492977157,1,4,5,10,1
1175,210,48,2504.901078596161,3,5,3,11,1
1176,347,14,3350.659785069913,1,2,4,7,2
1177,17,27,1411.9296507405063,5,3,2,10,1
1178,128,19,2619.5427313737396,4,2,3,9,2
1179,364,31,1756.999689673837,1,4,2,7,2
1180,251,46,1612.4838115780396,2,5,2,9,2
1181,179,9,1242.374551371359,3,1,2,6,3
1182,182,38,2050.9444234820685,3,4,3,10,1
1183,152,17,3303.5502520438145,3,2,4,9,2
1184,25,19,1117.998442574874,5,2,2,9,2
1185,180,44,4827.565494517977,3,5,5,13,0
1186,198,4,631.8122655536966,3,1,1,5,3
1187,344,48,2406.2339665299673,1,5,3,9,2
1188,161,11,434.29079961319354,3,2,1,6,3
1189,177,22,123.0999521343598,3,3,1,7,2
1190,285,4,4614.159825294833,2,1,5,8,2
1191,63,17,4053.820121813664,5,2,5,12,1
1192,150,8,3473.835311896536,3,1,4,8,2
1193,154,46,4327.302157618225,3,5,5,13,0
1194,156,34,4016.2136306189454,3,4,5,12,1
1195,49,11,3239.7162277220973,5,2,4,11,1
1196,337,31,4238.238205584163,1,4,5,10,1
1197,84,11,1960.094761765925,4,2,2,8,2
1198,361,38,2768.2316478432795,1,4,3,8,2
1199,177,21,3883.7901583634416,3,3,4,10,1
1200,148,46,433.14210106926976,3,5,1,9,2
1201,118,30,4294.640881140795,4,3,5,12,1
1202,342,10,792.5839739260591,1,1,1,3,3
1203,63,26,4324.06085195872,5,3,5,13,0
1204,189,27,1563.5510294483058,3,3,2,8,2
1205,360,8,1640.6464013864002,1,1,2,4,3
1206,49,39,379.0039624498093,5,4,1,10,1
1207,327,8,4430.63912323979,1,1,5,7,2
1208,257,8,880.8069079304391,2,1,1,4,3
1209,224,34,3153.949011164706,2,4,4,10,1
1210,141,16,3223.3983202750765,4,2,4,10,1
1211,215,41,1412.946002039083,3,5,2,10,1
1212,211,13,4928.448177709454,3,2,5,10,1
1213,318,23,330.1894283743137,1,3,1,5,3
1214,32,12,3043.2813348476766,5,2,4,11,1
1215,158,27,2402.9241980113734,3,3,3,9,2
1216,285,22,1234.9656946649004,2,3,2,7,2
1217,305,32,826.1230395015027,1,4,1,6,3
1218,286,49,3688.050947213342,2,5,4,11,1
1219,144,27,4582.41122366112,4,3,5,12,1
1220,19,2,546.6558471540648,5,1,1,7,2
1221,18,45,977.9612584089673,5,5,1,11,1
1222,257,33,4931.486039004872,2,4,5,11,1
1223,78,26,84.96314444699436,4,3,1,8,2
1224,175,28,2546.1773285680874,3,3,3,9,2
1225,194,19,2585.4031219082535,3,2,3,8,2
1226,113,43,1323.1760104774114,4,5,2,11,1
1227,114,5,3318.5141134138676,4,1,4,9,2
1228,222,33,4725.255123070799,2,4,5,11,1
1229,166,20,2256.56751547332,3,2,3,8,2
1230,319,30,3749.6033319519406,1,3,4,8,2
1231,132,45,3233.8905937645764,4,5,4,13,0
1232,264,8,2369.979899073157,2,1,3,6,3
1233,55,38,258.56337601799135,5,4,1,10,1
1234,359,17,3711.3315267368034,1,2,4,7,2
1235,131,44,1822.6247211361,4,5,2,11,1
1236,288,1,1130.2284951280803,2,1,2,5,3
1237,266,3,4741.860562442971,2,1,5,8,2
1238,162,46,3869.7788200403384,3,5,4,12,1
1239,87,26,4811.720721567913,4,3,5,12,1
1240,55,31,1288.5224915062943,5,4,2,11,1
1241,288,8,4180.608704613657,2,1,5,8,2
1242,178,43,3042.5298072672263,3,5,4,12,1
1243,349,46,4907.703409623066,1,5,5,11,1
1244,8,8,4732.12155861215,5,1,5,11,1
1245,321,35,4865.110544264085,1,4,5,10,1
1246,313,39,4759.32041551631,1,4,5,10,1
1247,247,28,48.22772578329055,2,3,1,6,3
1248,323,4,3708.01619665194,1,1,4,6,3
1249,255,16,1366.9534604361124,2,2,2,6,3
1250,328,13,3528.085206807115,1,2,4,7,2
1251,54,20,4903.249894257005,5,2,5,12,1
1252,249,5,206.40335958680652,2,1,1,4,3
1253,239,37,2839.2692838723588,2,4,3,9,2
1254,229,20,3677.416259002679,2,2,4,8,2
1255,67,24,1274.2603232518863,5,3,2,10,1
1256,51,36,1133.3584659650408,5,4,2,11,1
1257,97,34,311.12407195538617,4,4,1,9,2
1258,92,45,478.6600872686973,4,5,1,10,1
1259,264,48,3287.182055133324,2,5,4,11,1
1260,291,34,2531.0009889694347,2,4,3,9,2
1261,96,19,160.06041513491022,4,2,1,7,2
1262,88,17,4848.612176176302,4,2,5,11,1
1263,78,5,3283.6688887491373,4,1,4,9,2
1264,288,25,2582.1881593898815,2,3,3,8,2
1265,120,18,1370.8939407658522,4,2,2,8,2
1266,302,8,3293.9134351894413,1,1,4,6,3
1267,165,27,1827.1976357847366,3,3,2,8,2
1268,182,15,3515.445871685823,3,2,4,9,2
1269,223,45,3416.0338823307534,2,5,4,11,1
1270,311,13,472.7915376694054,1,2,1,4,3
1271,7,16,4547.210934471848,5,2,5,12,1
1272,330,22,2440.0015154923894,1,3,3,7,2
1273,263,20,1970.795245443104,2,2,2,6,3
1274,161,13,4777.756096707605,3,2,5,10,1
1275,151,20,2196.664312744946,3,2,3,8,2
1276,85,2,3608.8923753462914,4,1,4,9,2
1277,147,35,3279.1310214766822,3,4,4,11,1
1278,112,47,834.0490894344526,4,5,1,10,1
1279,36,19,4955.802440978254,5,2,5,12,1
1280,285,45,2323.3855682315243,2,5,3,10,1
1281,188,37,1979.9650363623696,3,4,2,9,2
1282,82,6,4598.871328838618,4,1,5,10,1
1283,2,14,2650.899299519779,5,2,3,10,1
1284,303,4,3528.3340400272687,1,1,4,6,3
1285,197,22,4232.767775837435,3,3,5,11,1
1286,11,39,1185.1170346653466,5,4,2,11,1
1287,234,36,855.6382601207023,2,4,1,7,2
1288,195,34,351.8489598991198,3,4,1,8,2
1289,119,27,4486.695163237866,4,3,5,12,1
1290,20,7,1009.8318027683122,5,1,1,7,2
1291,261,3,1545.6926798813254,2,1,2,5,3
1292,293,47,1436.1765611339658,1,5,2,8,2
1293,256,33,1529.8940577367507,2,4,2,8,2
1294,222,2,3343.625022875305,2,1,4,7,2
1295,226,42,4771.026658115286,2,5,5,12,1
1296,53,16,1653.9726454281265,5,2,2,9,2
1297,355,25,2044.1593017468972,1,3,3,7,2
1298,342,15,3858.0234507019695,1,2,4,7,2
1299,364,24,2167.3663414965526,1,3,3,7,2
1300,280,15,4630.953411950977,2,2,5,9,2
1301,81,31,2521.0580732186304,4,4,3,11,1
1302,202,14,1745.196930260441,3,2,2,7,2
1303,158,14,4858.146693834005,3,2,5,10,1
1304,120,6,2134.651561560258,4,1,3,8,2
1305,59,14,1163.5626072283326,5,2,2,9,2
1306,215,17,896.7270657997693,3,2,1,6,3
1307,128,18,4975.954815883345,4,2,5,11,1
1308,224,20,3767.408588712957,2,2,4,8,2
1309,209,17,2049.2123893013522,3,2,3,8,2
1310,115,16,4133.553080832428,4,2,5,11,1
1311,209,40,2738.5625862772804,3,4,3,10,1
1312,14,39,1593.7739724300295,5,4,2,11,1
1313,9,32,3719.4951855924373,5,4,4,13,0
1314,40,44,3732.0147470269276,5,5,4,14,0
1315,237,9,2505.8444536288334,2,1,3,6,3
1316,281,27,235.3401183739269,2,3,1,6,3
1317,359,46,394.3422080026014,1,5,1,7,2
1318,201,33,3945.8599002163432,3,4,4,11,1
1319,246,10,4119.147116181184,2,1,5,8,2
1320,278,17,3394.6658454001395,2,2,4,8,2
1321,235,49,4196.952191334238,2,5,5,12,1
1322,4,49,3600.242477084484,5,5,4,14,0
1323,154,36,4485.703756339491,3,4,5,12,1
1324,29,17,760.4873803402688,5,2,1,8,2
1325,109,18,1944.8302263510986,4,2,2,8,2
1326,98,23,2325.912861515188,4,3,3,10,1
1327,215,34,1495.342335843486,3,4,2,9,2
1328,293,8,3629.578576265726,1,1,4,6,3
1329,75,13,4563.0696753188095,4,2,5,11,1
1330,326,23,2068.2861743536887,1,3,3,7,2
1331,146,20,4708.294403343853,4,2,5,11,1
1332,128,22,2588.676846648843,4,3,3,10,1
1333,341,47,2617.352977812095,1,5,3,9,2
1334,42,23,3005.095507982005,5,3,3,11,1
1335,356,41,1348.9720149454336,1,5,2,8,2
1336,41,35,1922.9689904838347,5,4,2,11,1
1337,34,3,2770.6548898986184,5,1,3,9,2
1338,17,34,4710.494599010576,5,4,5,14,0
1339,165,33,3217.03596649154,3,4,4,11,1
1340,153,46,1672.2516238646606,3,5,2,10,1
1341,76,17,62.23818084934817,4,2,1,7,2
1342,87,45,4908.51159315023,4,5,5,14,0
1343,117,19,2469.9929435137933,4,2,3,9,2
1344,362,30,4693.0908400705475,1,3,5,9,2
1345,342,23,2751.232716836914,1,3,3,7,2
1346,27,15,3031.2696525092206,5,2,3,10,1
1347,313,14,3562.4421569608207,1,2,4,7,2
1348,287,2,1611.6689109853837,2,1,2,5,3
1349,134,39,3497.9299637684226,4,4,4,12,1
1350,219,49,2638.6916301584047,2,5,3,10,1
1351,168,18,3365.6749484167085,3,2,4,9,2
1352,98,6,4180.807971940101,4,1,5,10,1
1353,268,32,929.3033600571999,2,4,1,7,2
1354,237,21,3071.6190425754407,2,3,4,9,2
1355,309,40,270.0355297630845,1,4,1,6,3
1356,173,28,519.5542938556939,3,3,1,7,2
1357,190,27,3376.225236320579,3,3,4,10,1
1358,122,2,363.9788825235141,4,1,1,6,3
1359,46,33,2980.8353212717298,5,4,3,12,1
1360,64,16,1107.8628672704133,5,2,2,9,2
1361,130,39,1527.3832942736226,4,4,2,10,1
1362,310,22,656.8861457156577,1,3,1,5,3
1363,363,43,1250.850756002468,1,5,2,8,2
1364,193,47,4108.246006248447,3,5,5,13,0
1365,307,13,3198.0032439765723,1,2,4,7,2
1366,181,2,4749.301375617145,3,1,5,9,2
1367,292,14,253.23682821523883,1,2,1,4,3
1368,282,38,3964.1358659485027,2,4,4,10,1
1369,29,41,3498.395144564329,5,5,4,14,0
1370,149,28,1311.852602935705,3,3,2,8,2
1371,267,7,3648.5418470248164,2,1,4,7,2
1372,296,18,3585.577264073955,1,2,4,7,2
1373,11,41,2302.1325632631315,5,5,3,13,0
1374,164,36,3446.311698080008,3,4,4,11,1
1375,113,41,2228.4587060451754,4,5,3,12,1
1376,187,36,1684.372524328782,3,4,2,9,2
1377,295,44,2337.7898920812117,1,5,3,9,2
1378,232,4,4476.696112649029,2,1,5,8,2
1379,227,30,1929.0731263724886,2,3,2,7,2
1380,310,24,2024.4040055087526,1,3,3,7,2
1381,98,20,3045.9321058340306,4,2,4,10,1
1382,55,46,3767.4673824137703,5,5,4,14,0
1383,111,31,3675.7580929526707,4,4,4,12,1
1384,152,24,108.79566328960468,3,3,1,7,2
1385,246,7,3440.2025117640774,2,1,4,7,2
1386,69,26,2258.264700013645,5,3,3,11,1
1387,312,13,2625.2089380967427,1,2,3,6,3
1388,289,8,2812.7000513454664,2,1,3,6,3
1389,250,5,3661.2808893702445,2,1,4,7,2
1390,36,44,4158.351588205482,5,5,5,15,0
1391,239,13,3234.842113714858,2,2,4,8,2
1392,148,29,2823.897031821946,3,3,3,9,2
1393,227,20,1875.1085815153822,2,2,2,6,3
1394,244,14,698.0123139674182,2,2,1,5,3
1395,337,32,4793.302631407872,1,4,5,10,1
1396,201,27,2314.593038703285,3,3,3,9,2
1397,154,25,2835.3991000419924,3,3,3,9,2
1398,73,4,3757.8549657877215,5,1,4,10,1
1399,201,21,351.36832004934746,3,3,1,7,2
1400,296,18,4276.50493492862,1,2,5,8,2
1401,17,39,3987.158459278613,5,4,4,13,0
1402,129,15,3874.398623730107,4,2,4,10,1
1403,217,38,119.69370660469785,3,4,1,8,2
1404,61,48,2637.329068537967,5,5,3,13,0
1405,104,24,280.79916995485985,4,3,1,8,2
1406,42,8,2758.8541684479833,5,1,3,9,2
1407,25,28,3595.057148015057,5,3,4,12,1
1408,39,21,618.0327487895302,5,3,1,9,2
1409,291,16,3477.46669633167,2,2,4,8,2
1410,131,16,2253.1689014666827,4,2,3,9,2
1411,229,35,4059.6491240823216,2,4,5,11,1
1412,108,17,2672.6088075077023,4,2,3,9,2
1413,172,9,1687.2464638148974,3,1,2,6,3
1414,102,35,1666.637901484306,4,4,2,10,1
1415,354,29,4488.457734837844,1,3,5,9,2
1416,12,39,2269.82920707981,5,4,3,12,1
1417,275,18,2034.7119469103407,2,2,3,7,2
1418,101,12,208.96937526659875,4,2,1,7,2
1419,44,19,1827.9797795258542,5,2,2,9,2
1420,305,48,4249.63900417268,1,5,5,11,1
1421,17,22,3807.3284060977194,5,3,4,12,1
1422,330,49,1112.3568819550328,1,5,2,8,2
1423,57,15,2071.1525498353813,5,2,3,10,1
1424,311,1,990.9325836479269,1,1,1,3,3
1425,303,2,4771.541916005187,1,1,5,7,2
1426,12,8,2994.608213892323,5,1,3,9,2
1427,318,22,3774.230414817258,1,3,4,8,2
1428,80,25,3571.905161887127,4,3,4,11,1
1429,216,2,4369.709923316516,3,1,5,9,2
1430,339,9,4747.145614941842,1,1,5,7,2
1431,264,9,171.906407140865,2,1,1,4,3
1432,149,13,4876.752887700763,3,2,5,10,1
1433,81,6,4354.006890898339,4,1,5,10,1
1434,215,30,1920.9075694035005,3,3,2,8,2
1435,198,15,4186.9755203597815,3,2,5,10,1
1436,200,15,3685.424331831438,3,2,4,9,2
1437,25,7,3967.640739681562,5,1,4,10,1
1438,89,11,1111.2482538668862,4,2,2,8,2
1439,268,40,3246.3328726589702,2,4,4,10,1
1440,143,38,139.3702125534612,4,4,1,9,2
1441,59,40,4242.663371438715,5,4,5,14,0
1442,26,2,4755.704432654187,5,1,5,11,1
1443,47,48,3313.9959687700866,5,5,4,14,0
1444,288,39,2568.2215693482503,2,4,3,9,2
1445,266,10,3631.398135921725,2,1,4,7,2
1446,16,44,1638.5428282408386,5,5,2,12,1
1447,199,17,3135.675101104565,3,2,4,9,2
1448,282,7,3597.6749671391567,2,1,4,7,2
1449,86,40,721.9770995911259,4,4,1,9,2
1450,250,39,708.9393474279959,2,4,1,7,2
1451,270,4,3583.529506794391,2,1,4,7,2
1452,335,35,2164.594645885825,1,4,3,8,2
1453,117,47,4447.115477319891,4,5,5,14,0
1454,7,36,1566.5750219626198,5,4,2,11,1
1455,137,31,221.72937887073627,4,4,1,9,2
1456,176,25,3252.881385865283,3,3,4,10,1
1457,328,41,3424.3537407468775,1,5,4,10,1
1458,315,13,2772.4221288037643,1,2,3,6,3
1459,215,18,3419.829902016044,3,2,4,9,2
1460,82,21,2623.5341789272306,4,3,3,10,1
1461,223,48,3466.2377523342375,2,5,4,11,1
1462,103,1,229.24765871042064,4,1,1,6,3
1463,273,36,1848.3028774028971,2,4,2,8,2
1464,14,8,1061.9764205888862,5,1,2,8,2
1465,159,48,505.6374316720203,3,5,1,9,2
1466,152,21,1178.1222544686989,3,3,2,8,2
1467,108,43,964.6399839786229,4,5,1,10,1
1468,188,21,4865.92562792437,3,3,5,11,1
1469,301,27,1439.864129415129,1,3,2,6,3
1470,98,19,1162.485261034326,4,2,2,8,2
1471,131,23,4176.023786282274,4,3,5,12,1
1472,293,43,2101.389924171506,1,5,3,9,2
1473,171,35,2113.1125877620525,3,4,3,10,1
1474,183,40,2223.5164272369575,3,4,3,10,1
1475,364,42,2088.507185541867,1,5,3,9,2
1476,39,48,1639.5616202446533,5,5,2,12,1
1477,15,5,1438.8338183484013,5,1,2,8,2
1478,4,41,4410.978785662352,5,5,5,15,0
1479,349,8,816.9196572154275,1,1,1,3,3
1480,210,11,913.5011410854669,3,2,1,6,3
1481,161,16,2862.8783111209614,3,2,3,8,2
1482,16,39,1724.8563125170479,5,4,2,11,1
1483,108,47,2113.4315305866658,4,5,3,12,1
1484,311,24,4034.6675733745083,1,3,5,9,2
1485,227,21,4519.118991281756,2,3,5,10,1
1486,170,23,3954.86286098717,3,3,4,10,1
1487,34,49,1182.2920338208503,5,5,2,12,1
1488,251,38,4900.056735149161,2,4,5,11,1
1489,247,47,1822.2507390723183,2,5,2,9,2
1490,269,8,853.6446352114189,2,1,1,4,3
1491,141,7,2502.4885602855197,4,1,3,8,2
1492,274,2,3629.175990478386,2,1,4,7,2
1493,96,30,425.5216977272894,4,3,1,8,2
1494,227,13,3175.0917039590286,2,2,4,8,2
1495,39,23,4291.808837898716,5,3,5,13,0
1496,302,29,1316.2895986335175,1,3,2,6,3
1497,29,38,3468.6848287617704,5,4,4,13,0
1498,318,37,2005.5440635025986,1,4,2,7,2
1499,245,20,2076.5343642665125,2,2,3,7,2
1500,236,33,1411.2620157324748,2,4,2,8,2
1501,185,29,3125.725044235078,3,3,4,10,1
1502,272,15,1811.3862726204713,2,2,2,6,3
1503,236,23,4156.205987273276,2,3,5,10,1
1504,239,42,4814.898061017159,2,5,5,12,1
1505,266,3,4676.087523404213,2,1,5,8,2
1506,359,37,824.0105812350129,1,4,1,6,3
1507,340,29,80.8095969738051,1,3,1,5,3
1508,65,45,2197.957022199567,5,5,3,13,0
1509,177,8,3647.1297012842115,3,1,4,8,2
1510,3,22,4887.501788991455,5,3,5,13,0
1511,142,29,3919.2772848448067,4,3,4,11,1
1512,158,2,2906.941116116529,3,1,3,7,2
1513,324,41,141.50103202544148,1,5,1,7,2
1514,146,49,4129.448050621699,4,5,5,14,0
1515,293,45,893.9537193067634,1,5,1,7,2
1516,153,1,287.47650579208414,3,1,1,5,3
1517,193,44,4253.29064829778,3,5,5,13,0
1518,73,20,2835.5918306813146,5,2,3,10,1
1519,305,21,651.4724733236422,1,3,1,5,3
1520,344,37,1938.847889238665,1,4,2,7,2
1521,140,8,436.85291945556105,4,1,1,6,3
1522,187,27,3193.673926569732,3,3,4,10,1
1523,293,47,1419.3120590499473,1,5,2,8,2
1524,61,35,4331.80971551322,5,4,5,14,0
1525,198,6,1795.4021838102628,3,1,2,6,3
1526,295,45,2478.2229764693893,1,5,3,9,2
1527,319,44,326.9817535548159,1,5,1,7,2
1528,302,19,1385.2071570534094,1,2,2,5,3
1529,344,18,3387.0686857360806,1,2,4,7,2
1530,11,1,3683.951211210424,5,1,4,10,1
1531,62,25,1221.681056506056,5,3,2,10,1
1532,333,27,2524.0622926163323,1,3,3,7,2
1533,226,7,4089.4802149704806,2,1,5,8,2
1534,153,44,1905.751702838881,3,5,2,10,1
1535,199,42,677.5186241103783,3,5,1,9,2
1536,52,29,2165.0332441662217,5,3,3,11,1
1537,260,31,3007.1370405058356,2,4,3,9,2
1538,59,44,46.91865567997379,5,5,1,11,1
1539,72,43,1749.3518583368373,5,5,2,12,1
1540,148,36,3041.1047462668716,3,4,4,11,1
1541,349,19,4760.040630722905,1,2,5,8,2
1542,63,6,2048.658175053567,5,1,3,9,2
1543,310,25,823.2316047418383,1,3,1,5,3
1544,243,31,2675.753298854598,2,4,3,9,2
1545,330,9,1435.9042818874052,1,1,2,4,3
1546,107,20,1081.749202580772,4,2,2,8,2
1547,226,10,2956.1122625500293,2,1,3,6,3
1548,313,37,4580.258836338666,1,4,5,10,1
1549,218,27,4177.768779653036,2,3,5,10,1
1550,241,13,919.6397689567714,2,2,1,5,3
1551,259,41,3831.7384971657834,2,5,4,11,1
1552,262,2,1157.0444855231126,2,1,2,5,3
1553,5,21,1460.5992908591638,5,3,2,10,1
1554,261,33,4601.057019348609,2,4,5,11,1
1555,54,24,4556.1402520617185,5,3,5,13,0
1556,47,44,851.4675150803602,5,5,1,11,1
1557,215,42,330.3173610581723,3,5,1,9,2
1558,177,34,1472.6593351523743,3,4,2,9,2
1559,9,9,2913.057548291065,5,1,3,9,2
1560,99,2,4385.6894723034675,4,1,5,10,1
1561,20,30,602.9985706134506,5,3,1,9,2
1562,241,22,2080.642925990573,2,3,3,8,2
1563,61,46,1366.031435735423,5,5,2,12,1
1564,178,11,84.49554650772815,3,2,1,6,3
1565,338,43,3944.346841357062,1,5,4,10,1
1566,62,17,4068.2882237067092,5,2,5,12,1
1567,145,36,1113.933018258829,4,4,2,10,1
1568,216,13,764.6888477014363,3,2,1,6,3
1569,3,7,731.3586595747639,5,1,1,7,2
1570,160,16,2325.096476923794,3,2,3,8,2
1571,227,33,1240.0129813044914,2,4,2,8,2
1572,269,45,2561.66465601762,2,5,3,10,1
1573,120,1,1930.4101683876802,4,1,2,7,2
1574,89,11,1062.3426214559463,4,2,2,8,2
1575,329,6,3758.4470298909982,1,1,4,6,3
1576,68,20,760.3158127757556,5,2,1,8,2
1577,357,35,3996.5225509539814,1,4,4,9,2
1578,98,44,2811.617454614558,4,5,3,12,1
1579,267,37,4161.865341955457,2,4,5,11,1
1580,105,41,33.74760994882604,4,5,1,10,1
1581,323,26,3748.45070998706,1,3,4,8,2
1582,123,12,267.06281032306543,4,2,1,7,2
1583,29,30,4750.992607998725,5,3,5,13,0
1584,137,28,3516.6700470687697,4,3,4,11,1
1585,195,27,1607.6597302005764,3,3,2,8,2
1586,226,42,1606.0539593002907,2,5,2,9,2
1587,332,19,4308.84697479594,1,2,5,8,2
1588,170,5,4515.172240978767,3,1,5,9,2
1589,9,5,4458.950672383331,5,1,5,11,1
1590,40,41,4045.6140599059745,5,5,5,15,0
1591,25,27,4096.969783973501,5,3,5,13,0
1592,261,28,2868.111835359022,2,3,3,8,2
1593,226,26,150.87295421585,2,3,1,6,3
1594,124,27,442.9986774743847,4,3,1,8,2
1595,38,49,3251.270714536938,5,5,4,14,0
1596,328,42,2011.8141500318645,1,5,3,9,2
1597,251,21,2840.875057899515,2,3,3,8,2
1598,176,1,1163.0773368844223,3,1,2,6,3
1599,90,28,3250.591696479528,4,3,4,11,1
1600,37,48,1221.71942552477,5,5,2,12,1
1601,316,15,2309.4558618970163,1,2,3,6,3
1602,176,17,2398.8122989599983,3,2,3,8,2
1603,284,26,896.5644668974044,2,3,1,6,3
1604,81,20,4382.276554674322,4,2,5,11,1
1605,114,25,2633.847070802869,4,3,3,10,1
1606,40,13,4335.251051912346,5,2,5,12,1
1607,301,33,1320.053120524661,1,4,2,7,2
1608,224,25,869.9563678860214,2,3,1,6,3
1609,318,8,99.90307162444704,1,1,1,3,3
1610,349,5,478.38465203527124,1,1,1,3,3
1611,115,6,745.8783183841933,4,1,1,6,3
1612,186,23,403.48925626606797,3,3,1,7,2
1613,323,30,4485.427682759515,1,3,5,9,2
1614,56,14,4558.0771566294015,5,2,5,12,1
1615,40,23,4687.439734652469,5,3,5,13,0
1616,354,11,4799.705574512587,1,2,5,8,2
1617,40,31,2464.256675049492,5,4,3,12,1
1618,347,6,2654.8229377565017,1,1,3,5,3
1619,237,11,662.8438385820266,2,2,1,5,3
1620,289,13,693.8896683827699,2,2,1,5,3
1621,262,12,3866.054628893777,2,2,4,8,2
1622,216,2,4280.088129867287,3,1,5,9,2
1623,147,35,3925.7250088491496,3,4,4,11,1
1624,336,36,4174.533566324816,1,4,5,10,1
1625,168,17,1390.085873987216,3,2,2,7,2
1626,92,28,2335.6682637504905,4,3,3,10,1
1627,353,28,2301.4049231429813,1,3,3,7,2
1628,59,22,4976.464181677234,5,3,5,13,0
1629,59,38,4746.398320377672,5,4,5,14,0
1630,304,7,2996.4456710657705,1,1,3,5,3
1631,169,15,698.4859343720599,3,2,1,6,3
1632,269,32,1300.394232767079,2,4,2,8,2
1633,363,11,1825.1701593588616,1,2,2,5,3
1634,45,24,4367.326181870214,5,3,5,13,0
1635,345,3,861.4559607462542,1,1,1,3,3
1636,181,30,1106.5371139742444,3,3,2,8,2
1637,170,6,1753.4296114324368,3,1,2,6,3
1638,356,2,4635.281841380383,1,1,5,7,2
1639,191,14,2524.0223329741716,3,2,3,8,2
1640,155,41,3237.711822621697,3,5,4,12,1
1641,188,18,1942.2442923001904,3,2,2,7,2
1642,7,44,950.7253344312489,5,5,1,11,1
1643,133,31,1121.774681668316,4,4,2,10,1
1644,235,13,4015.3293893762375,2,2,5,9,2
1645,45,26,4468.475371215993,5,3,5,13,0
1646,314,44,2470.4475229067934,1,5,3,9,2
1647,249,12,1791.40269202169,2,2,2,6,3
1648,31,18,4041.0973312710394,5,2,5,12,1
1649,23,9,3368.74292765383,5,1,4,10,1
1650,160,49,213.9611476533094,3,5,1,9,2
1651,363,21,1760.1970854252254,1,3,2,6,3
1652,158,48,3414.043161397849,3,5,4,12,1
1653,39,49,2872.662303251976,5,5,3,13,0
1654,82,40,4890.555871142651,4,4,5,13,0
1655,356,43,4331.915737344199,1,5,5,11,1
1656,258,24,308.0946445989923,2,3,1,6,3
1657,206,34,3631.5873882050796,3,4,4,11,1
1658,77,8,1688.2697955290846,4,1,2,7,2
1659,12,44,3413.5926883988727,5,5,4,14,0
1660,295,33,3089.9506845960677,1,4,4,9,2
1661,224,23,2520.220793142737,2,3,3,8,2
1662,13,13,4266.218276154379,5,2,5,12,1
1663,46,49,3546.3624021144074,5,5,4,14,0
1664,155,14,4448.880021365013,3,2,5,10,1
1665,113,14,1415.202708024216,4,2,2,8,2
1666,233,16,1747.1563477270643,2,2,2,6,3
1667,17,49,3113.5372355542395,5,5,4,14,0
1668,360,38,4832.657542435062,1,4,5,10,1
1669,223,39,1864.1946756925342,2,4,2,8,2
1670,354,26,171.145313836781,1,3,1,5,3
1671,188,26,2234.980897555564,3,3,3,9,2
1672,344,1,2724.2085170198256,1,1,3,5,3
1673,163,32,4006.9271694107206,3,4,4,11,1
1674,326,15,3645.716395183228,1,2,4,7,2
1675,74,21,4823.666776784497,4,3,5,12,1
1676,233,18,3915.5869751767664,2,2,4,8,2
1677,224,30,1500.1559009687346,2,3,2,7,2
1678,319,13,3210.487751791047,1,2,4,7,2
1679,60,24,3364.483555048796,5,3,4,12,1
1680,335,30,4990.1223689544095,1,3,5,9,2
1681,222,2,702.3021770216202,2,1,1,4,3
1682,37,19,964.7142584253794,5,2,1,8,2
1683,278,47,786.0130836033578,2,5,1,8,2
1684,196,44,2949.4099696881594,3,5,3,11,1
1685,352,47,685.1523504477603,1,5,1,7,2
1686,242,25,3283.4784674336324,2,3,4,9,2
1687,324,14,4020.832513812452,1,2,5,8,2
1688,219,6,2169.6366917922337,2,1,3,6,3
1689,192,12,2807.818558628426,3,2,3,8,2
1690,17,20,4564.483195623541,5,2,5,12,1
1691,12,23,2852.1339287117307,5,3,3,11,1
1692,193,30,1050.9417046539884,3,3,2,8,2
1693,22,30,1722.5370542323756,5,3,2,10,1
1694,120,38,2653.930558663948,4,4,3,11,1
1695,210,30,782.9394505930288,3,3,1,7,2
1696,306,41,3066.4739784307776,1,5,4,10,1
1697,270,30,4996.2379985012885,2,3,5,10,1
1698,192,36,3266.1494750554125,3,4,4,11,1
1699,175,49,1868.3316086320615,3,5,2,10,1
1700,285,34,1665.414993488502,2,4,2,8,2
1701,204,16,4658.700579810303,3,2,5,10,1
1702,164,24,4358.856309987493,3,3,5,11,1
1703,251,14,2367.0695147918486,2,2,3,7,2
1704,227,26,1773.538676856418,2,3,2,7,2
1705,7,8,3555.216775146298,5,1,4,10,1
1706,29,14,1579.3673530158712,5,2,2,9,2
1707,33,31,605.8221289401769,5,4,1,10,1
1708,134,2,1557.6595393846164,4,1,2,7,2
1709,79,48,2177.1369507648374,4,5,3,12,1
1710,58,4,1284.5027661537135,5,1,2,8,2
1711,26,1,1091.9004919302376,5,1,2,8,2
1712,226,20,40.63941169684175,2,2,1,5,3
1713,285,14,3157.9054792061925,2,2,4,8,2
1714,4,40,3076.1002221574336,5,4,4,13,0
1715,99,25,948.2459364759338,4,3,1,8,2
1716,39,25,4718.8138583378095,5,3,5,13,0
1717,271,3,2053.758800005743,2,1,3,6,3
1718,285,5,137.14237354576971,2,1,1,4,3
1719,157,38,1106.6618671515694,3,4,2,9,2
1720,75,26,3463.4167465132614,4,3,4,11,1
1721,288,40,1016.0832950648704,2,4,1,7,2
1722,130,38,279.02316979152,4,4,1,9,2
1723,175,38,3092.354044759418,3,4,4,11,1
1724,84,4,2596.5904050649733,4,1,3,8,2
1725,22,7,3808.7165221312825,5,1,4,10,1
1726,27,30,3865.4306288352673,5,3,4,12,1
1727,195,30,4800.076916400767,3,3,5,11,1
1728,337,19,294.5175446525084,1,2,1,4,3
1729,236,39,204.55720489295945,2,4,1,7,2
1730,92,35,4936.113269658027,4,4,5,13,0
1731,21,40,3227.7909097077995,5,4,4,13,0
1732,303,33,3579.698992941181,1,4,4,9,2
1733,357,33,491.4452784784906,1,4,1,6,3
1734,84,14,358.3653273332015,4,2,1,7,2
1735,262,38,809.6654337394972,2,4,1,7,2
1736,147,10,2141.706057959373,3,1,3,7,2
1737,257,28,559.7791518375487,2,3,1,6,3
1738,58,14,2237.2053647997313,5,2,3,10,1
1739,15,36,2812.06415647567,5,4,3,12,1
1740,162,38,11.661509746688663,3,4,1,8,2
1741,163,16,580.0856976519676,3,2,1,6,3
1742,320,21,1882.224006921715,1,3,2,6,3
1743,281,28,276.1156655570328,2,3,1,6,3
1744,280,33,676.309576827579,2,4,1,7,2
1745,12,6,1166.6639883752127,5,1,2,8,2
1746,274,41,2153.7110566965584,2,5,3,10,1
1747,271,15,3577.037617704179,2,2,4,8,2
1748,208,44,672.116173010971,3,5,1,9,2
1749,27,3,3692.413273827568,5,1,4,10,1
1750,72,43,4276.753041288932,5,5,5,15,0
1751,60,47,3260.8790467573144,5,5,4,14,0
1752,145,35,228.19122018471106,4,4,1,9,2
1753,93,14,2208.861897767932,4,2,3,9,2
1754,309,2,3303.7293481511642,1,1,4,6,3
1755,8,29,4892.7805416904885,5,3,5,13,0
1756,79,4,4759.523856465519,4,1,5,10,1
1757,27,26,1984.5587406551947,5,3,2,10,1
1758,174,12,3083.496050403212,3,2,4,9,2
1759,50,2,4455.1675853343095,5,1,5,11,1
1760,199,17,4156.92077440722,3,2,5,10,1
1761,349,35,2402.3149522226213,1,4,3,8,2
1762,181,10,1313.5942411492006,3,1,2,6,3
1763,24,48,694.1287345261766,5,5,1,11,1
1764,316,22,2445.0209738654635,1,3,3,7,2
1765,46,41,3617.000917963013,5,5,4,14,0
1766,15,43,4849.150868949167,5,5,5,15,0
1767,153,21,4310.456375067213,3,3,5,11,1
1768,222,15,1029.1623666883265,2,2,2,6,3
1769,206,35,3601.692852844125,3,4,4,11,1
1770,273,48,1452.6152567535678,2,5,2,9,2
1771,236,21,3420.528246223646,2,3,4,9,2
1772,340,21,3332.369247699255,1,3,4,8,2
1773,228,21,1369.4287085984517,2,3,2,7,2
1774,9,44,1179.5992148842595,5,5,2,12,1
1775,166,32,528.64943531874,3,4,1,8,2
1776,319,5,262.1927876550872,1,1,1,3,3
1777,214,39,4293.67078369379,3,4,5,12,1
1778,117,9,258.74847922885795,4,1,1,6,3
1779,344,18,452.8184209603194,1,2,1,4,3
1780,72,21,1201.8716564873173,5,3,2,10,1
1781,64,8,4439.415059026758,5,1,5,11,1
1782,205,44,1671.3723985067347,3,5,2,10,1
1783,209,34,967.0797917083949,3,4,1,8,2
1784,72,10,3580.6219240175246,5,1,4,10,1
1785,277,41,1602.1580767947416,2,5,2,9,2
1786,274,24,1673.4995240002193,2,3,2,7,2
1787,320,40,3697.493213733295,1,4,4,9,2
1788,338,24,1265.7475498854462,1,3,2,6,3
1789,95,32,4484.832638051072,4,4,5,13,0
1790,166,33,2811.494173211743,3,4,3,10,1
1791,32,38,2693.780238750346,5,4,3,12,1
1792,11,44,1331.113652980386,5,5,2,12,1
1793,301,49,4177.120757248329,1,5,5,11,1
1794,217,34,2868.020258848792,3,4,3,10,1
1795,289,11,786.0275740470776,2,2,1,5,3
1796,102,31,1039.4282038513654,4,4,2,10,1
1797,267,18,2346.596985015012,2,2,3,7,2
1798,214,23,3900.412693857779,3,3,4,10,1
1799,179,22,4697.083415348631,3,3,5,11,1
1800,88,43,3320.8581655809644,4,5,4,13,0
1801,41,18,2535.6548152959076,5,2,3,10,1
1802,76,40,1261.1525677850032,4,4,2,10,1
1803,46,47,3367.6111226741905,5,5,4,14,0
1804,160,41,4911.376381709001,3,5,5,13,0
1805,80,47,2386.3501529407827,4,5,3,12,1
1806,310,39,819.0879756605781,1,4,1,6,3
1807,86,20,525.6695014563511,4,2,1,7,2
1808,92,13,1353.5883511689174,4,2,2,8,2
1809,148,45,2851.515674916005,3,5,3,11,1
1810,161,1,4734.558452445731,3,1,5,9,2
1811,202,4,1502.8337644900919,3,1,2,6,3
1812,242,24,1533.9019451443062,2,3,2,7,2
1813,353,36,2411.0864989698402,1,4,3,8,2
1814,2,36,4593.526252144952,5,4,5,14,0
1815,225,45,2101.0847024395553,2,5,3,10,1
1816,289,2,1123.9146653860564,2,1,2,5,3
1817,233,28,824.023265759039,2,3,1,6,3
1818,77,26,2290.5066926696836,4,3,3,10,1
1819,116,23,4005.3804042934466,4,3,4,11,1
1820,154,15,1463.8484995747042,3,2,2,7,2
1821,103,36,2567.487969760908,4,4,3,11,1
1822,194,27,3019.01127938852,3,3,3,9,2
1823,166,6,2257.8473541729077,3,1,3,7,2
1824,359,35,966.534304352914,1,4,1,6,3
1825,90,39,4609.510932894928,4,4,5,13,0
1826,174,38,2831.591683820075,3,4,3,10,1
1827,122,35,3648.380575730289,4,4,4,12,1
1828,143,36,3183.854597135285,4,4,4,12,1
1829,106,10,4990.259628420593,4,1,5,10,1
1830,305,30,2286.9875708488935,1,3,3,7,2
1831,360,41,2130.612142762476,1,5,3,9,2
1832,317,38,1807.0979317891313,1,4,2,7,2
1833,123,29,1814.5260121079107,4,3,2,9,2
1834,9,43,1386.0933514790113,5,5,2,12,1
1835,262,39,4903.34432448127,2,4,5,11,1
1836,73,4,4355.20235116654,5,1,5,11,1
1837,359,5,1590.1982947365086,1,1,2,4,3
1838,223,4,1533.0929328026796,2,1,2,5,3
1839,41,36,526.6345960534235,5,4,1,10,1
1840,204,45,4386.38399394237,3,5,5,13,0
1841,264,16,1865.1125936247643,2,2,2,6,3
1842,328,25,2867.350806804188,1,3,3,7,2
1843,178,14,4502.884867115847,3,2,5,10,1
1844,348,11,2046.4222358862864,1,2,3,6,3
1845,318,29,4036.2715366799807,1,3,5,9,2
1846,84,34,2157.125274981298,4,4,3,11,1
1847,318,22,3507.695285698586,1,3,4,8,2
1848,111,14,2161.6101918889835,4,2,3,9,2
1849,251,24,1969.868081427916,2,3,2,7,2
1850,7,39,4953.639105413921,5,4,5,14,0
1851,84,26,3065.625711597839,4,3,4,11,1
1852,208,43,1843.2819962986664,3,5,2,10,1
1853,314,36,1296.519190663221,1,4,2,7,2
1854,22,39,208.4341874457857,5,4,1,10,1
1855,3,16,3535.766037841148,5,2,4,11,1
1856,127,38,1867.0655666943574,4,4,2,10,1
1857,297,32,4108.0582772560365,1,4,5,10,1
1858,188,6,1825.7036185053703,3,1,2,6,3
1859,362,34,1872.912670200901,1,4,2,7,2
1860,14,8,3898.1132219697133,5,1,4,10,1
1861,12,30,2452.438617195742,5,3,3,11,1
1862,87,27,4425.624905300951,4,3,5,12,1
1863,12,7,2954.7774259557145,5,1,3,9,2
1864,25,27,1210.8176194367388,5,3,2,10,1
1865,301,25,2845.676552957167,1,3,3,7,2
1866,243,46,29.96836291416308,2,5,1,8,2
1867,122,41,1568.8628998464087,4,5,2,11,1
1868,147,15,1047.6821790840752,3,2,2,7,2
1869,55,25,3274.397399458644,5,3,4,12,1
1870,238,22,688.8325316640271,2,3,1,6,3
1871,356,18,1457.5862593397508,1,2,2,5,3
1872,173,12,1663.2296860737429,3,2,2,7,2
1873,221,23,26.43321203078532,2,3,1,6,3
1874,119,45,243.36517558163993,4,5,1,10,1
1875,309,39,1562.5193786078382,1,4,2,7,2
1876,183,25,1119.558701427642,3,3,2,8,2
1877,288,10,593.3646256896262,2,1,1,4,3
1878,307,30,779.2666652062502,1,3,1,5,3
1879,300,10,4179.32943728663,1,1,5,7,2
1880,82,34,3419.764681808386,4,4,4,12,1
1881,211,46,2425.7464796982326,3,5,3,11,1
1882,150,13,4545.285133422293,3,2,5,10,1
1883,37,29,157.4684267986766,5,3,1,9,2
1884,352,38,1731.2253303596594,1,4,2,7,2
1885,312,41,4118.684750345254,1,5,5,11,1
1886,361,45,3145.162082980754,1,5,4,10,1
1887,59,9,4908.6202981150145,5,1,5,11,1
1888,131,13,4723.129467208164,4,2,5,11,1
1889,202,37,858.0130304641688,3,4,1,8,2
1890,243,14,4860.215116006401,2,2,5,9,2
1891,35,37,4728.2185820106215,5,4,5,14,0
1892,93,9,1874.3186159176753,4,1,2,7,2
1893,207,8,4914.572655527874,3,1,5,9,2
1894,353,39,188.86232009955805,1,4,1,6,3
1895,332,40,3307.145269017358,1,4,4,9,2
1896,305,3,1338.0775432793996,1,1,2,4,3
1897,350,47,656.020852010645,1,5,1,7,2
1898,213,40,2891.8992754697947,3,4,3,10,1
1899,159,33,1538.68803784412,3,4,2,9,2
1900,24,32,3337.4584656176435,5,4,4,13,0
1901,293,7,2704.5054500509573,1,1,3,5,3
1902,4,19,1969.0211105342107,5,2,2,9,2
1903,220,34,917.2925849613406,2,4,1,7,2
1904,364,14,3010.2384853861618,1,2,3,6,3
1905,20,47,4147.860841083003,5,5,5,15,0
1906,152,46,3004.0222978613133,3,5,3,11,1
1907,50,19,3056.507553310692,5,2,4,11,1
1908,177,26,2564.068447097364,3,3,3,9,2
1909,96,17,1947.3181854681754,4,2,2,8,2
1910,105,28,2292.7156277513955,4,3,3,10,1
1911,250,19,4947.813368029209,2,2,5,9,2
1912,117,27,3750.845825505398,4,3,4,11,1
1913,354,48,2158.491725260172,1,5,3,9,2
1914,228,19,2291.909035773057,2,2,3,7,2
1915,66,33,2503.1637186712137,5,4,3,12,1
1916,335,7,3299.9778299502764,1,1,4,6,3
1917,262,29,2335.1315887354185,2,3,3,8,2
1918,295,43,3434.0338010118244,1,5,4,10,1
1919,243,5,1652.647155172761,2,1,2,5,3
1920,186,30,2059.0917637854086,3,3,3,9,2
1921,246,49,4321.625092272197,2,5,5,12,1
1922,125,43,1651.2392169606978,4,5,2,11,1
1923,268,8,4822.539298543258,2,1,5,8,2
1924,131,42,870.7996854546158,4,5,1,10,1
1925,237,12,1215.9822803787915,2,2,2,6,3
1926,18,42,2323.76195626699,5,5,3,13,0
1927,40,13,3989.0695430162946,5,2,4,11,1
1928,21,26,3660.5616333653848,5,3,4,12,1
1929,225,18,880.5854278958047,2,2,1,5,3
1930,355,42,1191.0582795795062,1,5,2,8,2
1931,282,49,2880.5623153636793,2,5,3,10,1
1932,8,20,1482.8720790405278,5,2,2,9,2
1933,100,16,2117.4033691532213,4,2,3,9,2
1934,240,37,2438.104935680274,2,4,3,9,2
1935,87,3,2975.287566698519,4,1,3,8,2
1936,298,27,1262.7461089519343,1,3,2,6,3
1937,14,15,824.0693163392481,5,2,1,8,2
1938,334,34,1998.831305092192,1,4,2,7,2
1939,2,45,419.31086202944437,5,5,1,11,1
1940,293,22,2638.558203743652,1,3,3,7,2
1941,325,40,4199.629744582521,1,4,5,10,1
1942,41,23,603.6885405692658,5,3,1,9,2
1943,318,49,572.5253553263497,1,5,1,7,2
1944,316,4,410.2868163480872,1,1,1,3,3
1945,111,41,4240.827835911891,4,5,5,14,0
1946,14,23,412.71742569153344,5,3,1,9,2
1947,231,47,4917.47555656817,2,5,5,12,1
1948,84,9,1798.0731572901286,4,1,2,7,2
1949,130,24,1650.5231741209595,4,3,2,9,2
1950,231,21,467.2424429642756,2,3,1,6,3
1951,326,41,2932.3496510657,1,5,3,9,2
1952,145,46,2933.552239640431,4,5,3,12,1
1953,345,16,2474.0910781778125,1,2,3,6,3
1954,28,25,1561.99053460726,5,3,2,10,1
1955,66,26,1849.2186414264522,5,3,2,10,1
1956,163,49,1609.3119344319527,3,5,2,10,1
1957,229,45,2136.4705773197043,2,5,3,10,1
1958,261,9,1715.5226463513175,2,1,2,5,3
1959,164,15,3380.8314261275973,3,2,4,9,2
1960,301,39,1485.9744970128759,1,4,2,7,2
1961,303,33,1760.6827751573262,1,4,2,7,2
1962,287,1,2182.944825097849,2,1,3,6,3
1963,10,5,29.76955301179222,5,1,1,7,2
1964,195,9,2465.492045362251,3,1,3,7,2
1965,118,44,1286.5408179327437,4,5,2,11,1
1966,270,6,290.19076558234434,2,1,1,4,3
1967,80,28,4555.996280836326,4,3,5,12,1
1968,93,45,1618.8694820957905,4,5,2,11,1
1969,266,26,2136.1654657267945,2,3,3,8,2
1970,332,28,4138.442360107827,1,3,5,9,2
1971,350,40,842.2769640610618,1,4,1,6,3
1972,361,15,4253.040959810892,1,2,5,8,2
1973,257,6,1215.7733609061147,2,1,2,5,3
1974,133,27,2949.2990791604325,4,3,3,10,1
1975,276,38,3431.5351170292297,2,4,4,10,1
1976,264,4,4526.019589880199,2,1,5,8,2
1977,171,11,3042.113593473818,3,2,4,9,2
1978,1,21,2271.6266882375016,5,3,3,11,1
1979,313,30,2865.6240681854697,1,3,3,7,2
1980,64,18,1018.3914890736175,5,2,1,8,2
1981,284,35,3448.4809274077547,2,4,4,10,1
1982,121,3,942.5347531322706,4,1,1,6,3
1983,107,12,2790.6655842705018,4,2,3,9,2
1984,175,27,3241.54227018884,3,3,4,10,1
1985,204,30,4493.930070234695,3,3,5,11,1
1986,165,21,2256.4472316282963,3,3,3,9,2
1987,305,38,3878.9128006801707,1,4,4,9,2
1988,120,21,845.9771366383399,4,3,1,8,2
1989,44,38,789.4204288817868,5,4,1,10,1
1990,312,40,2628.7420884624516,1,4,3,8,2
1991,156,15,2985.7404178994143,3,2,3,8,2
1992,207,18,3165.381793257212,3,2,4,9,2
1993,108,29,3730.913469698654,4,3,4,11,1
1994,251,48,1481.7081239284375,2,5,2,9,2
1995,334,38,3116.812532043753,1,4,4,9,2
1996,130,21,948.8142128235501,4,3,1,8,2
1997,293,17,1102.7985681822659,1,2,2,5,3
1998,20,41,345.87135298566756,5,5,1,11,1
1999,282,18,3737.532924832264,2,2,4,8,2
2000,285,37,2539.894922224064,2,4,3,9,2
2001,1,38,1198.5466709418142,5,4,2,11,1
2002,119,12,2785.626251244449,4,2,3,9,2
2003,35,11,1777.6585911825998,5,2,2,9,2
2004,198,48,4187.67745234345,3,5,5,13,0
2005,245,49,2645.4579251688665,2,5,3,10,1
2006,59,20,158.7555070405924,5,2,1,8,2
2007,325,9,4925.625478835297,1,1,5,7,2
2008,161,1,380.7497057973119,3,1,1,5,3
2009,179,3,3482.831362611348,3,1,4,8,2
2010,206,21,2191.9066376210258,3,3,3,9,2
2011,12,23,1254.0958545352805,5,3,2,10,1
2012,276,9,3385.526589969886,2,1,4,7,2
2013,181,19,638.2277949878851,3,2,1,6,3
2014,242,45,4292.651025297893,2,5,5,12,1
2015,216,46,1260.5538097065296,3,5,2,10,1
2016,251,19,1813.6537553359967,2,2,2,6,3
2017,299,23,3166.8917451579396,1,3,4,8,2
2018,126,27,15.136284671179698,4,3,1,8,2
2019,217,27,2369.015585800447,3,3,3,9,2
2020,306,39,4472.30211829334,1,4,5,10,1
2021,285,36,3405.274049955445,2,4,4,10,1
2022,185,12,1945.6228210437864,3,2,2,7,2
2023,39,27,3305.517896440317,5,3,4,12,1
2024,223,46,4683.481430267665,2,5,5,12,1
2025,184,34,947.1485310115569,3,4,1,8,2
2026,178,33,2663.7219641049496,3,4,3,10,1
2027,294,28,1181.3405302533456,1,3,2,6,3
2028,340,31,4272.580949461815,1,4,5,10,1
2029,151,32,3608.0407554918006,3,4,4,11,1
2030,126,20,4007.368842044974,4,2,4,10,1
2031,301,40,4715.629143940899,1,4,5,10,1
2032,308,35,1169.2207941470863,1,4,2,7,2
2033,336,31,253.108665863582,1,4,1,6,3
2034,234,31,1461.6095636429427,2,4,2,8,2
2035,8,38,2001.7051500550683,5,4,2,11,1
2036,341,22,3129.5474352976034,1,3,4,8,2
2037,129,45,3990.545766753795,4,5,4,13,0
2038,264,41,1755.5184073539456,2,5,2,9,2
2039,157,9,2372.7499638172762,3,1,3,7,2
2040,352,9,3929.481657271098,1,1,4,6,3
2041,358,15,1134.3903443805889,1,2,2,5,3
2042,5,13,1093.4883204127748,5,2,2,9,2
2043,86,22,2950.272619251868,4,3,3,10,1
2044,175,16,2185.9235842841563,3,2,3,8,2
2045,290,32,4744.995047146821,2,4,5,11,1
2046,193,2,1791.5824094930445,3,1,2,6,3
2047,311,26,3800.1824614990965,1,3,4,8,2
2048,119,14,2919.6327898855384,4,2,3,9,2
2049,218,38,282.3346988288846,2,4,1,7,2
2050,114,34,431.0838845671476,4,4,1,9,2
2051,145,8,1023.7508760680512,4,1,1,6,3
2052,26,36,724.3315880166396,5,4,1,10,1
2053,136,21,1653.5637333257687,4,3,2,9,2
2054,303,46,2899.154690833464,1,5,3,9,2
2055,232,43,3015.7890896068575,2,5,3,10,1
2056,76,28,2942.961247962072,4,3,3,10,1
2057,328,46,596.8670868194388,1,5,1,7,2
2058,345,44,3005.124800193875,1,5,3,9,2
2059,302,48,2054.6369654183513,1,5,3,9,2
2060,289,6,4516.232799611108,2,1,5,8,2
2061,1,20,4560.801138577395,5,2,5,12,1
2062,147,31,3843.1873951523585,3,4,4,11,1
2063,287,33,3518.5046839851284,2,4,4,10,1
2064,142,44,583.6140594141904,4,5,1,10,1
2065,53,7,432.6241158176191,5,1,1,7,2
2066,304,8,4205.760117661289,1,1,5,7,2
2067,69,9,2140.8089241227012,5,1,3,9,2
2068,361,2,2262.297753252721,1,1,3,5,3
2069,90,17,4240.487519165022,4,2,5,11,1
2070,220,45,3110.9404857133336,2,5,4,11,1
2071,192,37,905.2421321015074,3,4,1,8,2
2072,63,42,1062.956012646929,5,5,2,12,1
2073,73,44,41.82207348382546,5,5,1,11,1
2074,161,17,3556.2437687684082,3,2,4,9,2
2075,169,38,2433.2021758874803,3,4,3,10,1
2076,89,35,4750.319925056789,4,4,5,13,0
2077,176,47,3572.923878228857,3,5,4,12,1
2078,269,39,524.7317772251679,2,4,1,7,2
2079,73,30,816.0918850969548,5,3,1,9,2
2080,245,6,2513.6059874487964,2,1,3,6,3
2081,77,4,4625.122101627036,4,1,5,10,1
2082,159,37,1243.7829385200698,3,4,2,9,2
2083,324,35,4129.645207543072,1,4,5,10,1
2084,98,9,1568.2393764770188,4,1,2,7,2
2085,102,6,1356.7869758833328,4,1,2,7,2
2086,132,13,4507.949819159174,4,2,5,11,1
2087,102,22,245.73554444253733,4,3,1,8,2
2088,19,28,3307.097783281881,5,3,4,12,1
2089,82,30,225.40589626330336,4,3,1,8,2
2090,279,36,4005.8112949920755,2,4,4,10,1
2091,339,2,4148.7277312279775,1,1,5,7,2
2092,331,36,4467.849307551658,1,4,5,10,1
2093,129,8,938.5894073543614,4,1,1,6,3
2094,344,45,631.2457980727382,1,5,1,7,2
2095,310,42,2522.639882325087,1,5,3,9,2
2096,89,9,1365.4467815846792,4,1,2,7,2
2097,213,1,3035.4243865128556,3,1,4,8,2
2098,143,13,2573.5989799480794,4,2,3,9,2
2099,65,15,732.8120300248796,5,2,1,8,2
2100,76,32,3698.959764320338,4,4,4,12,1
2101,199,34,4020.884048844393,3,4,5,12,1
2102,143,43,4815.58468174713,4,5,5,14,0
2103,316,31,1983.7389930420854,1,4,2,7,2
2104,93,14,1695.2973280529561,4,2,2,8,2
2105,305,47,969.3906535394927,1,5,1,7,2
2106,224,14,912.516625493901,2,2,1,5,3
2107,291,48,1612.055894046127,2,5,2,9,2
2108,102,29,4909.265344747798,4,3,5,12,1
2109,267,47,470.3707868735398,2,5,1,8,2
2110,355,19,1304.2373483666427,1,2,2,5,3
2111,110,27,439.0322004064576,4,3,1,8,2
2112,330,9,1375.4206497513303,1,1,2,4,3
2113,265,37,471.0831483282179,2,4,1,7,2
2114,3,37,2546.4612451125804,5,4,3,12,1
2115,85,43,2197.3947110663785,4,5,3,12,1
2116,282,28,878.5111486289501,2,3,1,6,3
2117,328,24,882.2913899381788,1,3,1,5,3
2118,304,28,3134.28427785977,1,3,4,8,2
2119,117,36,1941.7354815628107,4,4,2,10,1
2120,221,18,290.41273429895205,2,2,1,5,3
2121,154,25,4601.761072837669,3,3,5,11,1
2122,153,35,2030.7129041909038,3,4,3,10,1
2123,12,4,2959.3272987348737,5,1,3,9,2
2124,133,14,4428.205630092684,4,2,5,11,1
2125,304,39,2016.7733963955025,1,4,3,8,2
2126,293,26,4105.093596662134,1,3,5,9,2
2127,300,8,4574.61360076872,1,1,5,7,2
2128,228,24,878.5962444802171,2,3,1,6,3
2129,271,16,4463.537375416512,2,2,5,9,2
2130,43,20,607.963909064827,5,2,1,8,2
2131,343,15,1382.8857728028718,1,2,2,5,3
2132,326,7,4042.9751237746805,1,1,5,7,2
2133,302,17,4504.415895955182,1,2,5,8,2
2134,364,22,3423.852553981555,1,3,4,8,2
2135,21,22,533.0809891172388,5,3,1,9,2
2136,107,12,2619.7314617547154,4,2,3,9,2
2137,336,18,2867.4442041583593,1,2,3,6,3
2138,303,46,1416.4800527032812,1,5,2,8,2
2139,117,47,4956.566076432985,4,5,5,14,0
2140,124,15,1684.7835047283925,4,2,2,8,2
2141,281,37,1059.1712987783535,2,4,2,8,2
2142,292,16,559.5787829737238,1,2,1,4,3
2143,203,5,1898.7212917569584,3,1,2,6,3
2144,51,2,3466.1672713138064,5,1,4,10,1
2145,271,28,1164.7712955294915,2,3,2,7,2
2146,324,41,3850.025645143336,1,5,4,10,1
2147,277,27,685.6523259314183,2,3,1,6,3
2148,141,31,2207.934975583068,4,4,3,11,1
2149,275,41,3514.844963129144,2,5,4,11,1
2150,290,36,685.1939194113121,2,4,1,7,2
2151,334,47,2993.2326278749374,1,5,3,9,2
2152,52,43,3996.7730369603587,5,5,4,14,0
2153,27,1,2981.788992483141,5,1,3,9,2
2154,157,29,2562.2049823943125,3,3,3,9,2
2155,239,1,4193.114770482175,2,1,5,8,2
2156,156,8,4927.247546506071,3,1,5,9,2
2157,291,16,914.751632252322,2,2,1,5,3
2158,136,28,3459.8182432244103,4,3,4,11,1
2159,144,22,412.4811961542881,4,3,1,8,2
2160,106,18,223.77670962999642,4,2,1,7,2
2161,158,22,1411.2866614527404,3,3,2,8,2
2162,146,41,4854.88974474913,4,5,5,14,0
2163,2,12,2765.456300330999,5,2,3,10,1
2164,77,19,1348.6740063375019,4,2,2,8,2
2165,132,25,671.6046210607443,4,3,1,8,2
2166,90,5,4601.715181036548,4,1,5,10,1
2167,345,34,1818.2092435384889,1,4,2,7,2
2168,350,39,1540.4193792311212,1,4,2,7,2
2169,263,10,4291.237525675036,2,1,5,8,2
2170,351,47,3025.9701302372446,1,5,3,9,2
2171,108,7,851.4941970917196,4,1,1,6,3
2172,74,37,2113.337552280667,4,4,3,11,1
2173,39,47,4641.873029847482,5,5,5,15,0
2174,159,15,4507.005837076129,3,2,5,10,1
2175,71,42,359.84786569431105,5,5,1,11,1
2176,312,24,1350.3798318355848,1,3,2,6,3
2177,241,26,781.1515961654555,2,3,1,6,3
2178,298,26,2673.7204541491406,1,3,3,7,2
2179,36,46,3752.4167519812886,5,5,4,14,0
2180,84,26,1484.7606236682784,4,3,2,9,2
2181,263,10,3792.4004261527552,2,1,4,7,2
2182,310,17,3346.890709615149,1,2,4,7,2
2183,172,14,3643.828824943509,3,2,4,9,2
2184,173,2,4741.736129380239,3,1,5,9,2
2185,362,48,2128.813185325647,1,5,3,9,2
2186,47,13,1719.414442811281,5,2,2,9,2
2187,141,27,3422.3975685771215,4,3,4,11,1
2188,118,9,4039.710135974173,4,1,5,10,1
2189,277,7,965.3120056292659,2,1,1,4,3
2190,214,48,4235.530008065659,3,5,5,13,0
2191,220,10,298.6839300854661,2,1,1,4,3
2192,26,9,41.90482285933757,5,1,1,7,2
2193,9,22,800.5514755368353,5,3,1,9,2
2194,271,23,4893.54926299643,2,3,5,10,1
2195,10,7,2622.5912343127043,5,1,3,9,2
2196,121,48,242.37138345540575,4,5,1,10,1
2197,125,9,4985.906663408067,4,1,5,10,1
2198,170,27,3727.1071615868423,3,3,4,10,1
2199,72,24,4191.645328996569,5,3,5,13,0
2200,152,29,1072.5732271356164,3,3,2,8,2
2201,208,17,536.1926768394247,3,2,1,6,3
2202,49,20,2580.273864160996,5,2,3,10,1
2203,154,7,3863.15666456839,3,1,4,8,2
2204,347,43,3192.525455069303,1,5,4,10,1
2205,293,40,3158.9860642756735,1,4,4,9,2
2206,68,7,3787.909457604716,5,1,4,10,1
2207,50,28,1142.8339195120247,5,3,2,10,1
2208,152,19,3310.981216236837,3,2,4,9,2
2209,19,20,1966.6322389854329,5,2,2,9,2
2210,100,44,358.06989174849264,4,5,1,10,1
2211,60,39,1018.6916051544927,5,4,1,10,1
2212,167,40,3972.078658632414,3,4,4,11,1
2213,202,7,4480.69418342148,3,1,5,9,2
2214,345,6,1421.2808395266009,1,1,2,4,3
2215,146,25,959.9010806483536,4,3,1,8,2
2216,164,41,143.3552761834223,3,5,1,9,2
2217,242,13,4739.009969048191,2,2,5,9,2
2218,69,39,3422.436075925687,5,4,4,13,0
2219,175,40,4785.58022416537,3,4,5,12,1
2220,49,22,4320.607423023069,5,3,5,13,0
2221,108,49,1708.9282975251344,4,5,2,11,1
2222,226,17,572.2883983199789,2,2,1,5,3
2223,161,48,2500.2934063520875,3,5,3,11,1
2224,119,22,143.80085111017837,4,3,1,8,2
2225,149,34,758.0839744358137,3,4,1,8,2
2226,150,8,1174.828818785267,3,1,2,6,3
2227,293,49,3331.5765147609313,1,5,4,10,1
2228,143,45,2554.2885950309396,4,5,3,12,1
2229,160,18,1519.0735850028611,3,2,2,7,2
2230,11,24,2828.1943119647863,5,3,3,11,1
2231,138,42,634.7612179529528,4,5,1,10,1
2232,78,2,3780.983552824877,4,1,4,9,2
2233,77,2,3563.055342378889,4,1,4,9,2
2234,254,27,1090.3483516458416,2,3,2,7,2
2235,258,14,3035.893863323771,2,2,4,8,2
2236,320,48,2521.4799954432174,1,5,3,9,2
2237,291,39,313.4733961305007,2,4,1,7,2
2238,263,12,1397.9880450123107,2,2,2,6,3
2239,85,32,4997.418693079024,4,4,5,13,0
2240,146,28,506.68294894297196,4,3,1,8,2
2241,323,28,2536.9924220405824,1,3,3,7,2
2242,42,46,4248.17543552674,5,5,5,15,0
2243,125,25,1510.252846295768,4,3,2,9,2
2244,167,4,1310.936108578815,3,1,2,6,3
2245,241,26,4455.057327934715,2,3,5,10,1
2246,280,36,1531.1014354380495,2,4,2,8,2
2247,188,3,3260.951623151432,3,1,4,8,2
2248,302,1,3704.161791811603,1,1,4,6,3
2249,19,17,3945.2025690424543,5,2,4,11,1
2250,68,7,4973.850590161912,5,1,5,11,1
2251,218,48,4017.9284278524024,2,5,5,12,1
2252,102,5,3288.4906628687963,4,1,4,9,2
2253,42,19,4478.3631532172785,5,2,5,12,1
2254,288,39,4529.665731838348,2,4,5,11,1
2255,167,46,4866.100623721479,3,5,5,13,0
2256,109,34,3884.561669737666,4,4,4,12,1
2257,36,35,982.6873796846734,5,4,1,10,1
2258,232,49,3551.9323836309104,2,5,4,11,1
2259,229,16,384.89092380265424,2,2,1,5,3
2260,353,40,1596.6350102978136,1,4,2,7,2
2261,164,47,587.8794764747614,3,5,1,9,2
2262,73,39,4750.213608368825,5,4,5,14,0
2263,136,27,1700.3830199995666,4,3,2,9,2
2264,353,41,3568.9460757518164,1,5,4,10,1
2265,70,38,2860.8789945727754,5,4,3,12,1
2266,196,25,546.4819511551129,3,3,1,7,2
2267,269,26,2811.1087949255784,2,3,3,8,2
2268,49,14,3308.5074816901156,5,2,4,11,1
2269,316,14,4408.771113995012,1,2,5,8,2
2270,130,14,359.72735567152444,4,2,1,7,2
2271,5,25,1485.2135856332345,5,3,2,10,1
2272,27,36,3464.7813101239362,5,4,4,13,0
2273,160,4,181.31486300034123,3,1,1,5,3
2274,149,47,1025.7317463255797,3,5,2,10,1
2275,264,15,1101.165278059294,2,2,2,6,3
2276,230,32,3349.9387997401336,2,4,4,10,1
2277,200,18,1436.9437905824827,3,2,2,7,2
2278,50,14,3001.9823546781854,5,2,3,10,1
2279,67,1,4827.0887489147735,5,1,5,11,1
2280,300,42,3968.282480186157,1,5,4,10,1
2281,58,20,1671.1849951760853,5,2,2,9,2
2282,259,10,2367.275844508428,2,1,3,6,3
2283,342,10,1011.3627714840044,1,1,1,3,3
2284,326,24,88.44285141421464,1,3,1,5,3
2285,130,34,1455.6798366430426,4,4,2,10,1
2286,215,28,1853.3489699126415,3,3,2,8,2
2287,172,27,2826.1921928631923,3,3,3,9,2
2288,258,40,4720.892579826012,2,4,5,11,1
2289,102,1,4739.78184462845,4,1,5,10,1
2290,209,33,359.79051130785086,3,4,1,8,2
2291,291,4,3077.08194086054,2,1,4,7,2
2292,354,7,221.339727930402,1,1,1,3,3
2293,286,9,3243.924563330361,2,1,4,7,2
2294,116,16,597.3382807529815,4,2,1,7,2
2295,264,5,4732.550096860281,2,1,5,8,2
2296,150,34,4323.050025869457,3,4,5,12,1
2297,300,23,121.42086446138269,1,3,1,5,3
2298,36,43,3912.837305044703,5,5,4,14,0
2299,333,25,3183.126614681349,1,3,4,8,2
2300,287,13,2481.892261265552,2,2,3,7,2
2301,303,24,3017.1460888949173,1,3,3,7,2
2302,311,11,3394.4678017110564,1,2,4,7,2
2303,208,17,4423.442803046961,3,2,5,10,1
2304,106,37,3839.1147286032997,4,4,4,12,1
2305,158,13,2881.135318456653,3,2,3,8,2
2306,121,27,4124.832147117592,4,3,5,12,1
2307,55,20,4934.745552952965,5,2,5,12,1
2308,12,33,1507.9082842575406,5,4,2,11,1
2309,145,42,600.9192631511581,4,5,1,10,1
2310,136,32,3659.926820936412,4,4,4,12,1
2311,3,8,4893.195706225786,5,1,5,11,1
2312,144,29,592.3625468003132,4,3,1,8,2
2313,30,40,2164.219217461128,5,4,3,12,1
2314,237,19,320.7155345067539,2,2,1,5,3
2315,279,6,3884.894394426241,2,1,4,7,2
2316,348,44,4744.05649142839,1,5,5,11,1
2317,115,39,2499.9808307154794,4,4,3,11,1
2318,104,48,2053.510524828344,4,5,3,12,1
2319,118,41,4539.5179260201,4,5,5,14,0
2320,5,21,675.6080626924119,5,3,1,9,2
2321,360,22,4459.005714260377,1,3,5,9,2
2322,248,42,1966.7087539788236,2,5,2,9,2
2323,364,10,2801.437997665908,1,1,3,5,3
2324,321,10,2646.177604590262,1,1,3,5,3
2325,121,29,3083.7360803081206,4,3,4,11,1
2326,286,16,4711.195335649945,2,2,5,9,2
2327,149,1,4756.123891014215,3,1,5,9,2
2328,84,17,4157.42985314679,4,2,5,11,1
2329,231,30,965.804944418619,2,3,1,6,3
2330,288,26,1674.2464586984122,2,3,2,7,2
2331,161,46,2444.246002770178,3,5,3,11,1
2332,272,19,4528.2500874489015,2,2,5,9,2
2333,38,21,2609.1154709925972,5,3,3,11,1
2334,226,17,4887.403966697302,2,2,5,9,2
2335,142,46,4919.367446629387,4,5,5,14,0
2336,292,40,2996.9354547202834,1,4,3,8,2
2337,151,21,4388.701744343578,3,3,5,11,1
2338,114,41,4996.121332999255,4,5,5,14,0
2339,237,40,4250.085424925886,2,4,5,11,1
2340,66,45,3287.98595579941,5,5,4,14,0
2341,361,49,4227.21629234727,1,5,5,11,1
2342,341,19,422.44875833120716,1,2,1,4,3
2343,258,7,3177.758374473898,2,1,4,7,2
2344,249,17,1090.4449408526755,2,2,2,6,3
2345,331,1,589.1576167468634,1,1,1,3,3
2346,323,37,4465.427549117228,1,4,5,10,1
2347,180,6,3201.8282693526885,3,1,4,8,2
2348,190,26,1225.2972641503993,3,3,2,8,2
2349,154,2,1940.0436657233415,3,1,2,6,3
2350,196,32,4866.649961313425,3,4,5,12,1
2351,311,48,4312.288443869347,1,5,5,11,1
2352,262,5,87.7531595475747,2,1,1,4,3
2353,143,37,4899.206965710398,4,4,5,13,0
2354,342,31,1848.9620719988222,1,4,2,7,2
2355,316,12,3480.1366482697645,1,2,4,7,2
2356,101,35,3566.256057399876,4,4,4,12,1
2357,244,30,4559.305334178067,2,3,5,10,1
2358,12,48,4426.453772256037,5,5,5,15,0
2359,239,6,1415.830661333808,2,1,2,5,3
2360,49,15,3221.2420366457973,5,2,4,11,1
2361,42,15,1974.5900604157323,5,2,2,9,2
2362,166,16,2632.4632449340015,3,2,3,8,2
2363,82,20,2777.845841920346,4,2,3,9,2
2364,291,13,1987.7537946968735,2,2,2,6,3
2365,158,44,2324.8311619977294,3,5,3,11,1
2366,216,42,1049.6279169258457,3,5,2,10,1
2367,158,46,3042.1554524747444,3,5,4,12,1
2368,134,31,3797.209479059376,4,4,4,12,1
2369,67,34,2154.40860857514,5,4,3,12,1
2370,336,29,4888.623640138303,1,3,5,9,2
2371,7,3,295.55977298322813,5,1,1,7,2
2372,14,9,2949.9118019186003,5,1,3,9,2
2373,73,11,2922.1678594843725,5,2,3,10,1
2374,163,11,191.11842926963976,3,2,1,6,3
2375,66,25,1130.6051602647128,5,3,2,10,1
2376,347,22,4528.657492411331,1,3,5,9,2
2377,130,42,2727.125082599977,4,5,3,12,1
2378,206,46,2187.5655160897236,3,5,3,11,1
2379,276,9,2083.327263228826,2,1,3,6,3
2380,256,20,4441.922551780345,2,2,5,9,2
2381,266,21,1841.4855663517133,2,3,2,7,2
2382,25,10,4297.242643008026,5,1,5,11,1
2383,281,22,1552.8710705541564,2,3,2,7,2
2384,253,29,2662.2048826691885,2,3,3,8,2
2385,310,9,727.6606499841849,1,1,1,3,3
2386,289,5,4126.901258094788,2,1,5,8,2
2387,164,40,3682.514606314091,3,4,4,11,1
2388,95,11,2655.164386739085,4,2,3,9,2
2389,270,1,139.24752432007423,2,1,1,4,3
2390,321,42,2411.4740859691947,1,5,3,9,2
2391,110,1,1133.7306758439818,4,1,2,7,2
2392,336,39,2072.7377364163467,1,4,3,8,2
2393,310,46,4283.568179404636,1,5,5,11,1
2394,238,5,3850.3204937001574,2,1,4,7,2
2395,25,49,1217.34501844291,5,5,2,12,1
2396,141,22,4924.917630298497,4,3,5,12,1
2397,117,26,4517.020426389435,4,3,5,12,1
2398,25,6,2648.0804812374945,5,1,3,9,2
2399,79,32,2655.4500982366876,4,4,3,11,1
2400,68,48,4507.317165366479,5,5,5,15,0
2401,173,11,3184.3625941117675,3,2,4,9,2
2402,12,10,2688.075175195237,5,1,3,9,2
2403,288,47,3748.2511331678375,2,5,4,11,1
2404,128,39,1183.1346052010538,4,4,2,10,1
2405,96,34,4393.103324281042,4,4,5,13,0
2406,92,31,2661.762049636191,4,4,3,11,1
2407,141,12,3021.4614819087874,4,2,3,9,2
2408,31,44,458.81991756162415,5,5,1,11,1
2409,334,16,1554.4497042235357,1,2,2,5,3
2410,20,38,2139.4093299937517,5,4,3,12,1
2411,146,3,2075.4085219457374,4,1,3,8,2
2412,316,2,3893.638987230505,1,1,4,6,3
2413,160,5,1418.7887634751398,3,1,2,6,3
2414,349,11,918.7252190918994,1,2,1,4,3
2415,43,25,2917.2600847966432,5,3,3,11,1
2416,254,35,3078.9241432517415,2,4,4,10,1
2417,130,35,616.700702360342,4,4,1,9,2
2418,60,22,22.317829900119992,5,3,1,9,2
2419,151,37,4589.068909309076,3,4,5,12,1
2420,287,22,407.3886155955369,2,3,1,6,3
2421,5,11,4490.355990390581,5,2,5,12,1
2422,266,32,2002.0822231881914,2,4,2,8,2
2423,345,35,3268.7489808953846,1,4,4,9,2
2424,130,31,936.2173066249172,4,4,1,9,2
2425,267,45,4121.34596885917,2,5,5,12,1
2426,178,8,909.1650006303728,3,1,1,5,3
2427,253,20,1938.6806500913845,2,2,2,6,3
2428,56,42,1197.7486396093236,5,5,2,12,1
2429,83,34,4189.154728857815,4,4,5,13,0
2430,99,4,4293.095710107908,4,1,5,10,1
2431,149,18,1866.424157957454,3,2,2,7,2
2432,329,4,1543.8185703113254,1,1,2,4,3
2433,156,20,3870.0912222238744,3,2,4,9,2
2434,190,9,4393.774739338143,3,1,5,9,2
2435,263,16,3123.8597706291785,2,2,4,8,2
2436,80,26,4637.744341888226,4,3,5,12,1
2437,252,38,1921.3886261219172,2,4,2,8,2
2438,97,25,767.9131460666376,4,3,1,8,2
2439,260,4,906.4184817620363,2,1,1,4,3
2440,260,41,3352.461441963128,2,5,4,11,1
2441,103,45,2043.5568511622964,4,5,3,12,1
2442,40,41,790.0098457256704,5,5,1,11,1
2443,273,38,1468.2120059690035,2,4,2,8,2
2444,101,19,2657.719309443415,4,2,3,9,2
2445,359,14,616.0118821410607,1,2,1,4,3
2446,308,21,27.17806973260457,1,3,1,5,3
2447,221,15,4587.3172570031065,2,2,5,9,2
2448,308,3,1531.2573419826476,1,1,2,4,3
2449,124,37,1115.2757452615015,4,4,2,10,1
2450,231,46,3495.419240543662,2,5,4,11,1
2451,178,16,4268.479583682582,3,2,5,10,1
2452,63,14,3165.0710490441857,5,2,4,11,1
2453,116,9,1279.8689429516728,4,1,2,7,2
2454,191,47,4309.566750538001,3,5,5,13,0
2455,62,7,2557.0317086748246,5,1,3,9,2
2456,256,14,1912.142106771632,2,2,2,6,3
2457,7,6,3027.58333696854,5,1,3,9,2
2458,155,21,3506.054995955199,3,3,4,10,1
2459,92,15,2973.21107183456,4,2,3,9,2
2460,14,8,4602.024774156801,5,1,5,11,1
2461,229,34,3143.8088519352777,2,4,4,10,1
2462,86,40,4394.117756001627,4,4,5,13,0
2463,133,1,2938.9225914178287,4,1,3,8,2
2464,183,32,1655.1010729133234,3,4,2,9,2
2465,62,49,2666.1611192411447,5,5,3,13,0
2466,219,5,440.8200813614968,2,1,1,4,3
2467,246,30,1158.5714231400134,2,3,2,7,2
2468,230,22,3833.4959943965464,2,3,4,9,2
2469,79,20,3310.763297315286,4,2,4,10,1
2470,149,16,840.9283655639682,3,2,1,6,3
2471,138,7,2195.6957295278253,4,1,3,8,2
2472,314,7,718.5411075919462,1,1,1,3,3
2473,65,2,4280.531103306131,5,1,5,11,1
2474,13,47,554.7568117539014,5,5,1,11,1
2475,213,14,3274.6326338340696,3,2,4,9,2
2476,242,31,3038.930004881064,2,4,4,10,1
2477,213,41,2369.1554617777806,3,5,3,11,1
2478,181,14,1398.3907670940675,3,2,2,7,2
2479,338,5,2025.7429349652168,1,1,3,5,3
2480,173,11,4033.8925893006244,3,2,5,10,1
2481,160,40,3810.1385695750514,3,4,4,11,1
2482,164,5,3696.6574846540707,3,1,4,8,2
2483,188,29,3751.6196859616784,3,3,4,10,1
2484,191,11,727.9930080331422,3,2,1,6,3
2485,308,5,504.4912873085339,1,1,1,3,3
2486,256,49,4308.878128041571,2,5,5,12,1
2487,183,32,4187.501106018775,3,4,5,12,1
2488,117,36,3409.7783371913533,4,4,4,12,1
2489,282,15,3033.469669124536,2,2,3,7,2
2490,196,19,1840.6898153471182,3,2,2,7,2
2491,34,22,1128.1721319742362,5,3,2,10,1
2492,52,34,3341.6056242718837,5,4,4,13,0
2493,112,17,4566.04284403156,4,2,5,11,1
2494,252,12,2190.6129129333685,2,2,3,7,2
2495,82,25,1523.0302264122886,4,3,2,9,2
2496,232,17,1361.0016493125606,2,2,2,6,3
2497,227,10,128.28916206974563,2,1,1,4,3
2498,233,28,2606.3804437483864,2,3,3,8,2
2499,221,18,4941.297788975609,2,2,5,9,2
2500,42,18,4078.0362035352186,5,2,5,12,1
2501,21,45,4488.398843644639,5,5,5,15,0
2502,42,32,3109.6088404147754,5,4,4,13,0
2503,113,14,2412.4175883089265,4,2,3,9,2
2504,105,16,4952.38046694472,4,2,5,11,1
2505,192,18,2241.338932087846,3,2,3,8,2
2506,17,16,4584.984572810099,5,2,5,12,1
2507,120,17,3811.6055958308375,4,2,4,10,1
2508,129,7,1661.5823419378828,4,1,2,7,2
2509,130,12,2520.2802944323953,4,2,3,9,2
2510,60,34,1927.8028166008696,5,4,2,11,1
2511,48,10,689.754138088165,5,1,1,7,2
2512,29,5,1790.265241995343,5,1,2,8,2
2513,97,21,4445.974692557671,4,3,5,12,1
2514,10,3,3765.6520698918494,5,1,4,10,1
2515,242,19,1395.1295607652935,2,2,2,6,3
2516,314,45,1845.8874323567165,1,5,2,8,2
2517,232,44,3086.0052758025436,2,5,4,11,1
2518,277,35,2086.537676892352,2,4,3,9,2
2519,284,6,2520.190140659169,2,1,3,6,3
2520,203,14,3493.860371368952,3,2,4,9,2
2521,247,4,2341.5817322386633,2,1,3,6,3
2522,290,45,962.939250439307,2,5,1,8,2
2523,264,18,2607.663947200998,2,2,3,7,2
2524,214,29,1787.0299687832912,3,3,2,8,2
2525,200,35,1460.763800008527,3,4,2,9,2
2526,79,38,1647.2617199215304,4,4,2,10,1
2527,343,16,2200.6210652751283,1,2,3,6,3
2528,344,20,4434.199582929389,1,2,5,8,2
2529,173,24,3672.944950607699,3,3,4,10,1
2530,69,35,3342.730873121796,5,4,4,13,0
2531,87,44,2361.58845229985,4,5,3,12,1
2532,101,19,19.13143627692032,4,2,1,7,2
2533,8,4,1709.3480500810658,5,1,2,8,2
2534,333,33,4067.828279497573,1,4,5,10,1
2535,200,2,1946.972838493521,3,1,2,6,3
2536,87,13,2823.457434087526,4,2,3,9,2
2537,43,45,1031.651683572013,5,5,2,12,1
2538,109,30,4580.130131810496,4,3,5,12,1
2539,152,34,4616.620474327962,3,4,5,12,1
2540,17,30,738.8912159521855,5,3,1,9,2
2541,133,24,3623.5531565395977,4,3,4,11,1
2542,148,48,385.4401536820458,3,5,1,9,2
2543,277,44,2996.7526137206883,2,5,3,10,1
2544,232,33,901.4817176217219,2,4,1,7,2
2545,314,41,737.0692099211273,1,5,1,7,2
2546,228,49,30.557888789422634,2,5,1,8,2
2547,139,10,4704.877112968343,4,1,5,10,1
2548,211,18,4147.969932687085,3,2,5,10,1
2549,28,19,396.60303071721574,5,2,1,8,2
2550,51,7,3000.8842942344463,5,1,3,9,2
2551,261,19,1172.162191648172,2,2,2,6,3
2552,261,24,1327.4392518766374,2,3,2,7,2
2553,350,15,4372.109905163203,1,2,5,8,2
2554,352,41,580.4854705499991,1,5,1,7,2
2555,8,42,3011.435776958587,5,5,3,13,0
2556,320,23,2012.2651195452554,1,3,3,7,2
2557,138,4,962.0949921551452,4,1,1,6,3
2558,38,38,2265.0711955606857,5,4,3,12,1
2559,111,4,4703.04154265958,4,1,5,10,1
2560,220,5,3910.2341456604554,2,1,4,7,2
2561,337,41,669.2358928046981,1,5,1,7,2
2562,223,44,4248.65440119106,2,5,5,12,1
2563,136,23,4687.828239647341,4,3,5,12,1
2564,256,40,1392.0517614026141,2,4,2,8,2
2565,360,37,1673.764280621585,1,4,2,7,2
2566,329,11,640.2865338440544,1,2,1,4,3
2567,49,11,1731.2511210644934,5,2,2,9,2
2568,292,13,3368.9725777266653,1,2,4,7,2
2569,324,14,1368.0535253303758,1,2,2,5,3
2570,78,8,44.05680372693076,4,1,1,6,3
2571,105,25,1699.3377916910226,4,3,2,9,2
2572,169,18,2271.3384045539756,3,2,3,8,2
2573,217,44,2836.1166267293393,3,5,3,11,1
2574,119,44,3422.287270746518,4,5,4,13,0
2575,190,18,318.30387770156284,3,2,1,6,3
2576,255,10,2354.062207044211,2,1,3,6,3
2577,266,7,1339.148688793252,2,1,2,5,3
2578,149,44,4740.368132067043,3,5,5,13,0
2579,164,14,1805.8935638716737,3,2,2,7,2
2580,140,15,509.61725661215314,4,2,1,7,2
2581,347,16,217.0425389501398,1,2,1,4,3
2582,258,2,1334.3753790985832,2,1,2,5,3
2583,269,30,902.6049070243866,2,3,1,6,3
2584,181,30,3252.5001381249263,3,3,4,10,1
2585,160,18,4236.3630431210895,3,2,5,10,1
2586,351,31,1569.6679303166097,1,4,2,7,2
2587,288,44,2893.1793602528473,2,5,3,10,1
2588,288,48,3654.2233321354556,2,5,4,11,1
2589,226,13,1998.4535688052815,2,2,2,6,3
2590,11,20,340.9648005769572,5,2,1,8,2
2591,10,49,1153.6327055296483,5,5,2,12,1
2592,271,35,4416.49838236253,2,4,5,11,1
2593,273,23,4124.156528611926,2,3,5,10,1
2594,183,42,441.79731883134605,3,5,1,9,2
2595,153,33,1127.5041296025317,3,4,2,9,2
2596,315,38,3848.134757795367,1,4,4,9,2
2597,334,35,2434.6321776242116,1,4,3,8,2
2598,124,36,3802.2354881616643,4,4,4,12,1
2599,114,20,1063.351433594111,4,2,2,8,2
2600,278,3,4763.963714459671,2,1,5,8,2
2601,213,8,3920.2011695114975,3,1,4,8,2
2602,172,40,995.2871008817801,3,4,1,8,2
2603,288,32,2796.661511393145,2,4,3,9,2
2604,174,29,574.3546692003265,3,3,1,7,2
2605,113,7,1813.5597274812478,4,1,2,7,2
2606,122,2,3301.5106286928485,4,1,4,9,2
2607,32,21,1657.3371627645706,5,3,2,10,1
2608,222,6,3287.22439483226,2,1,4,7,2
2609,119,28,1231.449528657202,4,3,2,9,2
2610,39,48,3608.8218348600044,5,5,4,14,0
2611,268,42,1804.3519738604462,2,5,2,9,2
2612,233,36,3954.5015418480716,2,4,4,10,1
2613,18,32,692.0826744418896,5,4,1,10,1
2614,149,45,1816.2699672679032,3,5,2,10,1
2615,149,42,2325.022944335674,3,5,3,11,1
2616,126,46,2124.9891672578774,4,5,3,12,1
2617,302,9,2171.141577556497,1,1,3,5,3
2618,360,11,2229.5686333919125,1,2,3,6,3
2619,238,23,4944.129590910929,2,3,5,10,1
2620,135,11,973.8539453155771,4,2,1,7,2
2621,151,49,3845.6325142379355,3,5,4,12,1
2622,236,2,2763.426017722223,2,1,3,6,3
2623,224,3,2074.0058063681718,2,1,3,6,3
2624,203,11,3171.30829870457,3,2,4,9,2
2625,256,35,4269.1219010680215,2,4,5,11,1
2626,86,15,2338.525436125899,4,2,3,9,2
2627,150,43,4325.358831115727,3,5,5,13,0
2628,235,11,478.0536914456589,2,2,1,5,3
2629,345,31,3268.8902677455635,1,4,4,9,2
2630,22,28,1672.5685059911073,5,3,2,10,1
2631,348,28,1939.7094830880988,1,3,2,6,3
2632,285,32,2859.3885570124753,2,4,3,9,2
2633,269,25,2404.7848235048855,2,3,3,8,2
2634,258,20,1915.0793981641734,2,2,2,6,3
2635,29,28,1548.5338748804595,5,3,2,10,1
2636,213,25,3095.393358135346,3,3,4,10,1
2637,283,11,2532.84246262983,2,2,3,7,2
2638,50,19,1623.3125362992932,5,2,2,9,2
2639,95,28,1032.7554841990184,4,3,2,9,2
2640,88,1,3874.5962978591233,4,1,4,9,2
2641,44,5,4000.5774733941603,5,1,4,10,1
2642,278,10,1076.8027536312113,2,1,2,5,3
2643,171,42,1315.6285760905557,3,5,2,10,1
2644,189,46,1203.3236822824197,3,5,2,10,1
2645,353,34,4424.003030426942,1,4,5,10,1
2646,184,36,3872.910601498634,3,4,4,11,1
2647,3,2,382.1218810174036,5,1,1,7,2
2648,191,18,4165.003089637158,3,2,5,10,1
2649,118,13,193.89058542170022,4,2,1,7,2
2650,19,5,1273.4669570052333,5,1,2,8,2
2651,23,20,4595.767006642109,5,2,5,12,1
2652,30,2,4323.013160883385,5,1,5,11,1
2653,295,11,3909.3582284758277,1,2,4,7,2
2654,108,30,2293.1606732551554,4,3,3,10,1
2655,281,32,1613.8563640898387,2,4,2,8,2
2656,128,32,4408.913729326879,4,4,5,13,0
2657,229,38,3288.7997104433684,2,4,4,10,1
2658,111,28,1484.5891866884892,4,3,2,9,2
2659,136,10,2321.3474310475867,4,1,3,8,2
2660,362,22,4408.68610908548,1,3,5,9,2
2661,186,17,4518.2426260303255,3,2,5,10,1
2662,144,22,3299.91744891893,4,3,4,11,1
2663,72,43,3665.4537449779987,5,5,4,14,0
2664,129,19,206.09618781172964,4,2,1,7,2
2665,364,17,3026.9565331095687,1,2,3,6,3
2666,261,24,3448.072916171175,2,3,4,9,2
2667,3,36,111.68196393035588,5,4,1,10,1
2668,104,32,4220.8563499017155,4,4,5,13,0
2669,224,46,4642.1422081371975,2,5,5,12,1
2670,320,36,1197.3028975697523,1,4,2,7,2
2671,362,28,4230.521704157853,1,3,5,9,2
2672,354,14,3330.9077877187297,1,2,4,7,2
2673,10,36,2907.6721405534904,5,4,3,12,1
2674,302,6,4217.198608708852,1,1,5,7,2
2675,231,9,1435.1965733685663,2,1,2,5,3
2676,219,21,3956.3723266574016,2,3,4,9,2
2677,66,12,1579.4586306643341,5,2,2,9,2
2678,112,30,3939.408149111288,4,3,4,11,1
2679,13,31,2260.759488724723,5,4,3,12,1
2680,86,40,593.5579027504714,4,4,1,9,2
2681,234,4,1913.7841029268925,2,1,2,5,3
2682,90,31,1175.1314587656557,4,4,2,10,1
2683,314,27,511.6524384232334,1,3,1,5,3
2684,54,25,560.3324714340882,5,3,1,9,2
2685,12,5,3902.5562785352085,5,1,4,10,1
2686,209,6,4408.175284087113,3,1,5,9,2
2687,14,5,4636.374305968195,5,1,5,11,1
2688,121,27,4271.191399928969,4,3,5,12,1
2689,20,8,4152.818245454355,5,1,5,11,1
2690,75,9,353.49089906786384,4,1,1,6,3
2691,243,15,3952.7167376613347,2,2,4,8,2
2692,223,36,3918.5804716856906,2,4,4,10,1
2693,70,41,665.1390665820198,5,5,1,11,1
2694,312,7,3313.4260673538156,1,1,4,6,3
2695,211,32,2268.011608931815,3,4,3,10,1
2696,101,8,4501.067482125633,4,1,5,10,1
2697,186,47,3480.0877283543805,3,5,4,12,1
2698,132,15,4755.427806507519,4,2,5,11,1
2699,111,37,533.5639999204719,4,4,1,9,2
2700,132,19,212.63049911744199,4,2,1,7,2
2701,20,39,4868.160995225125,5,4,5,14,0
2702,24,6,410.15888561007284,5,1,1,7,2
2703,227,19,1937.1171463420453,2,2,2,6,3
2704,154,28,3253.3534050302683,3,3,4,10,1
2705,293,17,4401.482799937078,1,2,5,8,2
2706,230,42,1280.3408178874909,2,5,2,9,2
2707,310,19,155.00047730626642,1,2,1,4,3
2708,359,31,2611.2210845909553,1,4,3,8,2
2709,202,11,2360.848981158484,3,2,3,8,2
2710,38,15,1541.396979123507,5,2,2,9,2
2711,260,10,4370.757843832232,2,1,5,8,2
2712,188,43,3749.117636200341,3,5,4,12,1
2713,57,23,4292.000752164241,5,3,5,13,0
2714,20,3,817.426707791224,5,1,1,7,2
2715,273,3,3465.1356751123017,2,1,4,7,2
2716,119,18,4875.7576597400985,4,2,5,11,1
2717,71,25,3063.450320125374,5,3,4,12,1
2718,4,43,865.1081828244759,5,5,1,11,1
2719,221,20,4978.944168395991,2,2,5,9,2
2720,14,29,2646.334671976307,5,3,3,11,1
2721,3,22,4201.894501198473,5,3,5,13,0
2722,216,15,755.3136226778523,3,2,1,6,3
2723,229,39,3333.8201266120277,2,4,4,10,1
2724,336,10,4563.9623140372805,1,1,5,7,2
2725,186,21,2664.768917368577,3,3,3,9,2
2726,55,29,1450.413702318174,5,3,2,10,1
2727,254,32,645.8349215083566,2,4,1,7,2
2728,24,10,1486.7638795392681,5,1,2,8,2
2729,162,13,1780.8721726050212,3,2,2,7,2
2730,158,47,3552.6759750968495,3,5,4,12,1
2731,82,23,901.3208210777137,4,3,1,8,2
2732,159,23,539.463230019884,3,3,1,7,2
2733,188,31,1940.828309758435,3,4,2,9,2
2734,60,4,2298.6815458815977,5,1,3,9,2
2735,305,49,3145.64141056535,1,5,4,10,1
2736,319,3,3540.581193491686,1,1,4,6,3
2737,211,21,4447.495767079662,3,3,5,11,1
2738,152,2,1451.8782919849,3,1,2,6,3
2739,109,4,2647.7530352327253,4,1,3,8,2
2740,76,1,1836.5431269472954,4,1,2,7,2
2741,30,15,17.09414343464052,5,2,1,8,2
2742,314,33,2901.3647953724385,1,4,3,8,2
2743,117,6,4080.8224175989817,4,1,5,10,1
2744,356,7,191.83303565593653,1,1,1,3,3
2745,192,19,27.4238754288215,3,2,1,6,3
2746,19,44,3641.8138484885826,5,5,4,14,0
2747,173,1,3422.4600277940776,3,1,4,8,2
2748,228,39,2035.2020056217543,2,4,3,9,2
2749,350,19,3311.4083592883394,1,2,4,7,2
2750,183,45,4767.396501929694,3,5,5,13,0
2751,113,26,1246.835354810965,4,3,2,9,2
2752,183,44,1237.1737067126032,3,5,2,10,1
2753,146,12,939.2987017734272,4,2,1,7,2
2754,319,22,3622.6938823690143,1,3,4,8,2
2755,116,13,1772.414298474987,4,2,2,8,2
2756,113,28,4943.578738595782,4,3,5,12,1
2757,251,14,3576.0980282511846,2,2,4,8,2
2758,251,22,1843.210664370449,2,3,2,7,2
2759,303,30,754.4383099766891,1,3,1,5,3
2760,313,44,2964.2038344733337,1,5,3,9,2
2761,118,20,1481.5672329511633,4,2,2,8,2
2762,301,44,4528.49031566847,1,5,5,11,1
2763,161,27,2212.607955383609,3,3,3,9,2
2764,198,38,1470.3233230473854,3,4,2,9,2
2765,260,42,2946.8735547076967,2,5,3,10,1
2766,148,41,693.5027598456127,3,5,1,9,2
2767,240,34,2812.129873286363,2,4,3,9,2
2768,47,39,289.9962778135035,5,4,1,10,1
2769,198,41,3038.3745219185657,3,5,4,12,1
2770,47,44,2655.5175810681303,5,5,3,13,0
2771,78,37,2608.6222508734686,4,4,3,11,1
2772,124,1,3423.980291418325,4,1,4,9,2
2773,75,15,231.83850598915663,4,2,1,7,2
2774,359,32,2304.060008505178,1,4,3,8,2
2775,137,8,2225.752928571469,4,1,3,8,2
2776,90,33,2304.3143847940714,4,4,3,11,1
2777,325,18,4899.655945616063,1,2,5,8,2
2778,61,45,704.999580989859,5,5,1,11,1
2779,138,29,3455.2444877273665,4,3,4,11,1
2780,50,32,2015.9607255189967,5,4,3,12,1
2781,259,33,2563.515356379323,2,4,3,9,2
2782,107,5,3814.3455902224187,4,1,4,9,2
2783,113,18,795.3034584416703,4,2,1,7,2
2784,350,48,3820.2902110560963,1,5,4,10,1
2785,254,10,360.9506055953536,2,1,1,4,3
2786,118,36,2421.7144609370666,4,4,3,11,1
2787,198,33,3712.9335799209066,3,4,4,11,1
2788,337,23,970.8317622199501,1,3,1,5,3
2789,51,40,3856.8690737167626,5,4,4,13,0
2790,245,5,842.3944095594587,2,1,1,4,3
2791,35,34,3998.2013971162355,5,4,4,13,0
2792,302,24,2349.9885089797694,1,3,3,7,2
2793,69,17,3426.3452759969027,5,2,4,11,1
2794,349,31,4587.858227262251,1,4,5,10,1
2795,320,7,2048.0234028325312,1,1,3,5,3
2796,49,17,1172.4580588456363,5,2,2,9,2
2797,74,28,4337.1488421222075,4,3,5,12,1
2798,192,38,816.467074042843,3,4,1,8,2
2799,261,22,3161.065498668709,2,3,4,9,2
2800,356,15,4617.033907322667,1,2,5,8,2
2801,70,37,3375.239590561175,5,4,4,13,0
2802,90,15,986.4486163955762,4,2,1,7,2
2803,260,25,769.8969192985325,2,3,1,6,3
2804,126,21,1269.0046001919493,4,3,2,9,2
2805,231,38,1963.1200959543262,2,4,2,8,2
2806,295,2,804.2035689310164,1,1,1,3,3
2807,129,27,3991.0921915421745,4,3,4,11,1
2808,280,49,1791.6063596183546,2,5,2,9,2
2809,313,32,4681.072812204505,1,4,5,10,1
2810,100,21,4214.029411536267,4,3,5,12,1
2811,326,4,4545.003131380416,1,1,5,7,2
2812,297,44,1479.5186478676646,1,5,2,8,2
2813,182,19,2872.9204036727288,3,2,3,8,2
2814,174,2,1614.0330950313637,3,1,2,6,3
2815,316,26,1292.1730727884296,1,3,2,6,3
2816,364,34,3039.3630382007277,1,4,4,9,2
2817,188,14,4091.7969491929125,3,2,5,10,1
2818,57,15,477.0530525720047,5,2,1,8,2
2819,31,20,1386.0861192166965,5,2,2,9,2
2820,84,34,1033.619562621775,4,4,2,10,1
2821,152,36,3993.7673640487606,3,4,4,11,1
2822,36,19,4667.526644730175,5,2,5,12,1
2823,213,9,408.9141238149613,3,1,1,5,3
2824,364,7,1902.2749393891327,1,1,2,4,3
2825,106,30,4573.400123166097,4,3,5,12,1
2826,342,13,1729.7447205260287,1,2,2,5,3
2827,220,27,3566.180567205379,2,3,4,9,2
2828,163,44,512.3252687315216,3,5,1,9,2
2829,220,35,2227.49378274459,2,4,3,9,2
2830,270,13,2521.470870202226,2,2,3,7,2
2831,120,15,3790.7437491454507,4,2,4,10,1
2832,336,46,1451.2350063933327,1,5,2,8,2
2833,182,9,1328.30097702713,3,1,2,6,3
2834,106,45,1521.8086742771986,4,5,2,11,1
2835,217,23,2782.9255788807664,3,3,3,9,2
2836,205,36,4381.262023189106,3,4,5,12,1
2837,70,40,4156.397568341921,5,4,5,14,0
2838,44,3,299.1488254908995,5,1,1,7,2
2839,329,34,4395.9860053471975,1,4,5,10,1
2840,301,19,484.59577734977523,1,2,1,4,3
2841,228,28,2082.58686590116,2,3,3,8,2
2842,184,23,3829.368151878564,3,3,4,10,1
2843,107,40,416.7400698093764,4,4,1,9,2
2844,84,49,211.5944045820645,4,5,1,10,1
2845,338,45,1656.6790600178629,1,5,2,8,2
2846,250,7,3652.3287832080005,2,1,4,7,2
2847,363,41,2613.5646234848527,1,5,3,9,2
2848,21,12,2090.8393343423413,5,2,3,10,1
2849,196,14,4067.2358544034514,3,2,5,10,1
2850,178,46,3835.8792183492806,3,5,4,12,1
2851,7,15,3932.355616572483,5,2,4,11,1
2852,70,3,2304.036851506518,5,1,3,9,2
2853,127,15,107.0517200352361,4,2,1,7,2
2854,160,24,868.9634977227358,3,3,1,7,2
2855,248,46,3709.0891371003627,2,5,4,11,1
2856,203,8,3768.335624030629,3,1,4,8,2
2857,148,5,4861.770077379669,3,1,5,9,2
2858,143,4,959.0307692818619,4,1,1,6,3
2859,199,14,623.4046728816986,3,2,1,6,3
2860,154,16,702.5602723427118,3,2,1,6,3
2861,142,20,932.09269421996,4,2,1,7,2
2862,313,24,2647.057014144294,1,3,3,7,2
2863,165,6,4876.305200241016,3,1,5,9,2
2864,314,31,2951.2631001730288,1,4,3,8,2
2865,21,6,2618.2134475767475,5,1,3,9,2
2866,82,35,3370.0475896155167,4,4,4,12,1
2867,69,15,378.9126498832012,5,2,1,8,2
2868,131,29,4078.617129410325,4,3,5,12,1
2869,87,3,3237.9289211628134,4,1,4,9,2
2870,218,11,864.2464811567206,2,2,1,5,3
2871,305,3,3157.269951785157,1,1,4,6,3
2872,345,28,2985.077733203693,1,3,3,7,2
2873,341,10,333.6163976190548,1,1,1,3,3
2874,161,33,1341.9916672503239,3,4,2,9,2
2875,178,48,1960.7986982175134,3,5,2,10,1
2876,117,16,1231.993762090131,4,2,2,8,2
2877,196,10,1223.3768220992495,3,1,2,6,3
2878,327,33,2869.0128837501175,1,4,3,8,2
2879,86,36,2359.5864951315907,4,4,3,11,1
2880,289,3,3339.7879868227596,2,1,4,7,2
2881,81,5,4782.471364678485,4,1,5,10,1
2882,152,12,3306.174662560047,3,2,4,9,2
2883,61,44,2914.6587020898833,5,5,3,13,0
2884,61,13,4239.321863410833,5,2,5,12,1
2885,354,24,3164.0448217295084,1,3,4,8,2
2886,28,44,836.1507388409168,5,5,1,11,1
2887,43,32,1580.5960102977297,5,4,2,11,1
2888,169,16,3669.4678105951784,3,2,4,9,2
2889,86,32,3694.52809130483,4,4,4,12,1
2890,177,45,4935.173664041707,3,5,5,13,0
2891,17,37,3138.6046432275098,5,4,4,13,0
2892,98,36,4498.730488548668,4,4,5,13,0
2893,198,21,282.35574984174,3,3,1,7,2
2894,98,47,2835.449500605136,4,5,3,12,1
2895,65,12,4600.041643263956,5,2,5,12,1
2896,330,21,1443.3487335391958,1,3,2,6,3
2897,341,21,782.8342529331039,1,3,1,5,3
2898,5,43,1759.045698882834,5,5,2,12,1
2899,2,6,3963.2584745489016,5,1,4,10,1
2900,22,9,432.657065259765,5,1,1,7,2
2901,112,1,3005.689905261731,4,1,3,8,2
2902,57,12,686.8017131629396,5,2,1,8,2
2903,66,14,2183.3068833207585,5,2,3,10,1
2904,330,6,4830.225237742762,1,1,5,7,2
2905,98,1,983.7699065359635,4,1,1,6,3
2906,144,22,179.74257874170135,4,3,1,8,2
2907,125,34,2141.744661500433,4,4,3,11,1
2908,167,11,2892.7009825738733,3,2,3,8,2
2909,86,3,1494.6134978066593,4,1,2,7,2
2910,76,42,2713.422336849695,4,5,3,12,1
2911,344,6,4767.475711797416,1,1,5,7,2
2912,294,6,1565.7362292064408,1,1,2,4,3
2913,59,20,1554.0408856844613,5,2,2,9,2
2914,138,21,2419.011810425962,4,3,3,10,1
2915,99,2,2581.4285160978584,4,1,3,8,2
2916,192,26,16.81597011667523,3,3,1,7,2
2917,243,31,3083.2169047121506,2,4,4,10,1
2918,319,26,4986.813169836907,1,3,5,9,2
2919,49,32,1467.1201668575782,5,4,2,11,1
2920,32,10,3157.7421308699804,5,1,4,10,1
2921,277,23,33.062058619693374,2,3,1,6,3
2922,20,6,3025.589795361522,5,1,3,9,2
2923,154,23,2240.8708640448117,3,3,3,9,2
2924,68,28,2656.1628357887216,5,3,3,11,1
2925,214,49,2724.085787786995,3,5,3,11,1
2926,143,30,892.99531680627,4,3,1,8,2
2927,232,14,3852.1409281776587,2,2,4,8,2
2928,213,37,2781.793408841592,3,4,3,10,1
2929,79,32,1358.2703528900008,4,4,2,10,1
2930,214,49,4687.5339173615075,3,5,5,13,0
2931,116,34,73.74081292023958,4,4,1,9,2
2932,92,41,3632.426697858948,4,5,4,13,0
2933,270,44,1912.363576428948,2,5,2,9,2
2934,168,22,2617.4987082434213,3,3,3,9,2
2935,58,31,1464.6336497334523,5,4,2,11,1
2936,284,7,1613.0483595541325,2,1,2,5,3
2937,26,41,85.67941090839797,5,5,1,11,1
2938,66,21,3651.9269926723923,5,3,4,12,1
2939,248,16,3556.884069895585,2,2,4,8,2
2940,254,20,3275.2474200320385,2,2,4,8,2
2941,44,43,4390.973896114199,5,5,5,15,0
2942,97,44,4507.325226986586,4,5,5,14,0
2943,42,47,2786.6571539320244,5,5,3,13,0
2944,227,19,3427.269225414643,2,2,4,8,2
2945,262,48,64.88202134159438,2,5,1,8,2
2946,167,32,4233.251863787242,3,4,5,12,1
2947,279,15,4083.902986406193,2,2,5,9,2
2948,89,5,111.04060593323956,4,1,1,6,3
2949,178,11,2718.697831541174,3,2,3,8,2
2950,197,15,4534.211296481975,3,2,5,10,1
2951,307,29,915.1260552860895,1,3,1,5,3
2952,267,45,1769.6981585699198,2,5,2,9,2
2953,268,4,1661.9578558082185,2,1,2,5,3
2954,74,49,1786.14297224476,4,5,2,11,1
2955,8,36,219.0112919709594,5,4,1,10,1
2956,297,48,1402.2982419891782,1,5,2,8,2
2957,164,23,1481.3330003741758,3,3,2,8,2
2958,85,15,4330.701521963059,4,2,5,11,1
2959,72,46,1767.0588755871956,5,5,2,12,1
2960,55,44,2241.6115320688214,5,5,3,13,0
2961,47,3,1909.8829188031395,5,1,2,8,2
2962,238,32,612.1605135118931,2,4,1,7,2
2963,104,10,4951.880221050864,4,1,5,10,1
2964,210,40,4130.867701616607,3,4,5,12,1
2965,42,38,2709.1923320665605,5,4,3,12,1
2966,316,22,2387.0588270019653,1,3,3,7,2
2967,268,14,3249.7810800604157,2,2,4,8,2
2968,263,17,1638.8914311309586,2,2,2,6,3
2969,336,21,260.91152306884794,1,3,1,5,3
2970,259,48,2027.5408999372892,2,5,3,10,1
2971,283,15,4920.048111265225,2,2,5,9,2
2972,114,15,919.9105613298367,4,2,1,7,2
2973,363,1,2643.249407843332,1,1,3,5,3
2974,40,24,52.521767644677546,5,3,1,9,2
2975,220,12,618.9372607411381,2,2,1,5,3
2976,129,10,2940.086585330914,4,1,3,8,2
2977,8,46,1494.0955082440964,5,5,2,12,1
2978,101,42,4529.365587438518,4,5,5,14,0
2979,176,42,2036.7871321266014,3,5,3,11,1
2980,107,31,1048.0876496839521,4,4,2,10,1
2981,101,11,2732.5029287306706,4,2,3,9,2
2982,260,16,3976.9184395280536,2,2,4,8,2
2983,246,9,106.9042840250001,2,1,1,4,3
2984,275,47,2532.5453919639062,2,5,3,10,1
2985,32,14,3869.3985180684595,5,2,4,11,1
2986,137,19,526.9073866138255,4,2,1,7,2
2987,12,31,4514.964609476396,5,4,5,14,0
2988,302,9,1329.9418757345784,1,1,2,4,3
2989,16,36,861.3120024870057,5,4,1,10,1
2990,129,39,2950.387803784346,4,4,3,11,1
2991,63,26,883.4054176319643,5,3,1,9,2
2992,109,8,3401.710586652199,4,1,4,9,2
2993,21,24,2455.6093891721657,5,3,3,11,1
2994,158,8,558.6802491932779,3,1,1,5,3
2995,269,19,4563.32577156442,2,2,5,9,2
2996,162,47,3369.2949957181154,3,5,4,12,1
2997,260,48,2734.5052024035026,2,5,3,10,1
2998,102,30,1877.9596705971524,4,3,2,9,2
2999,223,22,682.9509243056539,2,3,1,6,3
3000,59,9,3540.516671595997,5,1,4,10,1
3001,247,44,4070.142541945006,2,5,5,12,1
3002,128,48,637.8360611921798,4,5,1,10,1
3003,283,4,2477.8924464453307,2,1,3,6,3
3004,325,37,2429.382473092523,1,4,3,8,2
3005,25,8,1756.0594240176385,5,1,2,8,2
3006,131,1,3948.8160580051076,4,1,4,9,2
3007,353,28,506.65362119616634,1,3,1,5,3
3008,196,6,1033.0459321117291,3,1,2,6,3
3009,281,47,17.99781690334867,2,5,1,8,2
3010,154,36,1871.1970865342441,3,4,2,9,2
3011,133,11,1462.9790578228562,4,2,2,8,2
3012,227,5,4336.299978953201,2,1,5,8,2
3013,189,24,3731.5931179400127,3,3,4,10,1
3014,265,47,431.5162608457368,2,5,1,8,2
3015,134,18,3707.3700161612282,4,2,4,10,1
3016,211,20,3380.2471048835896,3,2,4,9,2
3017,60,28,1415.804125265645,5,3,2,10,1
3018,364,13,87.14926577600414,1,2,1,4,3
3019,364,5,584.6603829296753,1,1,1,3,3
3020,213,30,1257.2060122466112,3,3,2,8,2
3021,216,1,4084.9456071000022,3,1,5,9,2
3022,226,22,2331.911001279965,2,3,3,8,2
3023,131,18,4592.793677030661,4,2,5,11,1
3024,76,46,3947.8508126470165,4,5,4,13,0
3025,286,5,1442.669817421594,2,1,2,5,3
3026,277,31,4228.357161336759,2,4,5,11,1
3027,156,6,592.4569536496776,3,1,1,5,3
3028,248,27,190.22642706547532,2,3,1,6,3
3029,218,25,3046.6052233574455,2,3,4,9,2
3030,190,29,1715.297744049397,3,3,2,8,2
3031,163,28,1653.8341764466093,3,3,2,8,2
3032,180,16,3439.1688487971205,3,2,4,9,2
3033,34,12,4252.01810083629,5,2,5,12,1
3034,41,20,1617.6557716476052,5,2,2,9,2
3035,307,18,1631.8189718922793,1,2,2,5,3
3036,338,34,2673.9166860690116,1,4,3,8,2
3037,314,23,3269.3861743813945,1,3,4,8,2
3038,75,45,1022.4999198203375,4,5,1,10,1
3039,279,27,4564.2689730302445,2,3,5,10,1
3040,176,49,3275.5384540215405,3,5,4,12,1
3041,150,17,3129.5574387268102,3,2,4,9,2
3042,273,48,4521.936223978163,2,5,5,12,1
3043,325,21,4537.252752166441,1,3,5,9,2
3044,108,40,686.3951019261816,4,4,1,9,2
3045,139,31,733.9267648595376,4,4,1,9,2
3046,350,3,3812.1240077113366,1,1,4,6,3
3047,271,17,4784.830928264413,2,2,5,9,2
3048,347,26,3335.9032557804085,1,3,4,8,2
3049,289,23,2062.471823049779,2,3,3,8,2
3050,212,6,3420.5309674709906,3,1,4,8,2
3051,272,28,1151.7697660191286,2,3,2,7,2
3052,66,8,4989.851836040841,5,1,5,11,1
3053,248,45,2161.1152371165003,2,5,3,10,1
3054,156,8,4659.11315251839,3,1,5,9,2
3055,47,19,2159.682283790237,5,2,3,10,1
3056,201,38,4641.417507798398,3,4,5,12,1
3057,148,29,1685.070352984779,3,3,2,8,2
3058,124,23,3805.1094934324756,4,3,4,11,1
3059,1,47,4755.500041920991,5,5,5,15,0
3060,247,32,3233.443584196884,2,4,4,10,1
3061,343,10,3391.050476616632,1,1,4,6,3
3062,128,27,523.4023641570352,4,3,1,8,2
3063,191,49,2376.357536347866,3,5,3,11,1
3064,67,1,4434.90947637307,5,1,5,11,1
3065,4,39,1212.1400827912837,5,4,2,11,1
3066,303,29,3943.931437356582,1,3,4,8,2
3067,294,45,3381.792330161666,1,5,4,10,1
3068,143,3,1122.699964055282,4,1,2,7,2
3069,191,47,1421.1281142871424,3,5,2,10,1
3070,21,37,2143.5288916022787,5,4,3,12,1
3071,227,31,634.394785448421,2,4,1,7,2
3072,313,11,4567.722772819453,1,2,5,8,2
3073,117,22,3699.394449309557,4,3,4,11,1
3074,302,18,1831.1708590178628,1,2,2,5,3
3075,142,35,1505.3308215717593,4,4,2,10,1
3076,39,6,3450.9985628587633,5,1,4,10,1
3077,355,3,2126.862400544178,1,1,3,5,3
3078,252,5,1154.3894938063129,2,1,2,5,3
3079,333,9,2156.4522573390495,1,1,3,5,3
3080,207,28,4357.771946280635,3,3,5,11,1
3081,210,19,352.34711633441765,3,2,1,6,3
3082,115,28,1848.107653936741,4,3,2,9,2
3083,225,27,4812.073720855655,2,3,5,10,1
3084,134,13,84.01089384835875,4,2,1,7,2
3085,251,38,4454.295184480781,2,4,5,11,1
3086,219,43,1880.4201559000255,2,5,2,9,2
3087,91,21,955.6958408315309,4,3,1,8,2
3088,354,27,84.74893988379159,1,3,1,5,3
3089,46,46,361.9087789799924,5,5,1,11,1
3090,38,6,867.4983874787192,5,1,1,7,2
3091,142,38,136.79209951409524,4,4,1,9,2
3092,100,49,1685.890841769123,4,5,2,11,1
3093,328,11,234.01664072835916,1,2,1,4,3
3094,190,47,3464.158148603942,3,5,4,12,1
3095,35,41,4096.346496551925,5,5,5,15,0
3096,147,17,4438.444978619747,3,2,5,10,1
3097,30,39,2750.149623036983,5,4,3,12,1
3098,334,7,4733.082610487529,1,1,5,7,2
3099,84,30,38.17079829323653,4,3,1,8,2
3100,281,21,678.7514275989722,2,3,1,6,3
3101,344,1,1472.8982438472667,1,1,2,4,3
3102,270,25,3947.2319653516415,2,3,4,9,2
3103,154,32,4428.091809267947,3,4,5,12,1
3104,102,8,3094.4909120173284,4,1,4,9,2
3105,215,5,1922.3493586016014,3,1,2,6,3
3106,150,30,3332.569561894459,3,3,4,10,1
3107,83,8,912.6878664015869,4,1,1,6,3
3108,110,49,2294.791520340436,4,5,3,12,1
3109,275,19,2542.6450506332167,2,2,3,7,2
3110,201,44,533.3073928459609,3,5,1,9,2
3111,284,30,179.02457450581537,2,3,1,6,3
3112,173,15,3753.026431777229,3,2,4,9,2
3113,327,36,2678.1847328057456,1,4,3,8,2
3114,206,44,1667.871122370898,3,5,2,10,1
3115,63,27,2191.770871989139,5,3,3,11,1
3116,73,13,4788.940032084048,5,2,5,12,1
3117,251,14,1930.7197218506135,2,2,2,6,3
3118,124,37,526.3613410023277,4,4,1,9,2
3119,121,48,2323.374876021085,4,5,3,12,1
3120,275,30,3243.7613836555624,2,3,4,9,2
3121,120,39,70.44444933845868,4,4,1,9,2
3122,317,47,1668.3793944757508,1,5,2,8,2
3123,164,13,1973.6369564509446,3,2,2,7,2
3124,286,16,2323.937080362089,2,2,3,7,2
3125,265,44,1515.404126435532,2,5,2,9,2
3126,320,7,3337.9420697447076,1,1,4,6,3
3127,161,48,4724.099026391803,3,5,5,13,0
3128,308,27,4570.85089843818,1,3,5,9,2
3129,89,45,3325.3231398969933,4,5,4,13,0
3130,142,35,2539.351490059808,4,4,3,11,1
3131,203,15,4130.81748094388,3,2,5,10,1
3132,309,28,4181.326567414232,1,3,5,9,2
3133,227,35,4149.569533570278,2,4,5,11,1
3134,334,7,797.6512299683045,1,1,1,3,3
3135,222,46,136.90738339608146,2,5,1,8,2
3136,41,46,4916.13511464307,5,5,5,15,0
3137,196,20,4798.6744366476605,3,2,5,10,1
3138,68,32,2826.2485198349277,5,4,3,12,1
3139,264,38,4965.38794641963,2,4,5,11,1
3140,2,40,3855.0297533916246,5,4,4,13,0
3141,361,32,2591.727115432718,1,4,3,8,2
3142,125,26,1952.7620250446798,4,3,2,9,2
3143,110,39,2968.3874153726556,4,4,3,11,1
3144,86,20,2583.8524873107413,4,2,3,9,2
3145,120,18,4969.074608238969,4,2,5,11,1
3146,127,15,2457.3969768860925,4,2,3,9,2
3147,255,22,4181.246220073915,2,3,5,10,1
3148,183,22,4069.982877459824,3,3,5,11,1
3149,16,21,366.31730479389256,5,3,1,9,2
3150,62,2,444.16376888004953,5,1,1,7,2
3151,158,40,3302.4524728589668,3,4,4,11,1
3152,268,43,1302.9489536091537,2,5,2,9,2
3153,35,18,3291.0599031385614,5,2,4,11,1
3154,267,23,731.6832126245148,2,3,1,6,3
3155,64,13,1991.3704537569615,5,2,2,9,2
3156,50,41,521.326628964664,5,5,1,11,1
3157,255,9,1417.6444533100403,2,1,2,5,3
3158,149,49,450.60996463727963,3,5,1,9,2
3159,325,7,4853.187489436418,1,1,5,7,2
3160,304,41,1981.3415882162526,1,5,2,8,2
3161,276,1,4506.931951811948,2,1,5,8,2
3162,357,2,4856.147127453953,1,1,5,7,2
3163,172,4,4548.717674036584,3,1,5,9,2
3164,201,14,2280.248725187382,3,2,3,8,2
3165,324,32,3896.6975149344657,1,4,4,9,2
3166,35,36,776.9604239375795,5,4,1,10,1
3167,216,2,483.214742957852,3,1,1,5,3
3168,65,40,4385.738324475333,5,4,5,14,0
3169,8,14,165.28952705920946,5,2,1,8,2
3170,301,20,4861.9134809768775,1,2,5,8,2
3171,343,25,3363.948061519923,1,3,4,8,2
3172,332,42,2103.8689767890382,1,5,3,9,2
3173,76,49,715.4628786414655,4,5,1,10,1
3174,174,8,3618.923443264014,3,1,4,8,2
3175,47,28,2819.9276544727304,5,3,3,11,1
3176,15,46,3558.523767158381,5,5,4,14,0
3177,361,21,2095.431806088316,1,3,3,7,2
3178,147,23,340.63781447394933,3,3,1,7,2
3179,26,32,1581.7112807481274,5,4,2,11,1
3180,308,8,1581.953558541307,1,1,2,4,3
3181,93,31,53.30900010492771,4,4,1,9,2
3182,232,37,57.8092653436283,2,4,1,7,2
3183,21,16,1660.483853130212,5,2,2,9,2
3184,307,40,3640.8406901480703,1,4,4,9,2
3185,38,42,3123.9782147802057,5,5,4,14,0
3186,276,27,1202.69805706548,2,3,2,7,2
3187,157,40,3017.785634339134,3,4,3,10,1
3188,179,41,3240.414201841863,3,5,4,12,1
3189,132,18,2617.623914896745,4,2,3,9,2
3190,311,35,2611.556336182244,1,4,3,8,2
3191,348,49,1855.0418865825698,1,5,2,8,2
3192,28,15,625.7378751286515,5,2,1,8,2
3193,260,27,1933.5641622516187,2,3,2,7,2
3194,76,17,1733.2182375726693,4,2,2,8,2
3195,67,40,2963.9432384515308,5,4,3,12,1
3196,342,2,4282.738242145376,1,1,5,7,2
3197,194,49,1883.1220725535213,3,5,2,10,1
3198,162,31,3551.579036719429,3,4,4,11,1
3199,347,37,4061.0335837073776,1,4,5,10,1
3200,361,41,1066.6400535166729,1,5,2,8,2
3201,257,41,4509.234382629796,2,5,5,12,1
3202,72,34,361.5202415150094,5,4,1,10,1
3203,87,34,4509.579500600477,4,4,5,13,0
3204,262,3,826.5281342196587,2,1,1,4,3
3205,214,17,1692.476318143235,3,2,2,7,2
3206,153,14,3030.123748639135,3,2,3,8,2
3207,210,14,4529.359995196418,3,2,5,10,1
3208,61,46,1285.950188420524,5,5,2,12,1
3209,268,38,3820.233828198212,2,4,4,10,1
3210,262,35,3555.0746831219376,2,4,4,10,1
3211,218,1,806.9467230894139,2,1,1,4,3
3212,283,48,2402.5250834757967,2,5,3,10,1
3213,136,29,2412.7104149563843,4,3,3,10,1
3214,362,4,1530.012955136684,1,1,2,4,3
3215,93,33,3901.8073695136186,4,4,4,12,1
3216,109,17,4630.409923341762,4,2,5,11,1
3217,241,28,3585.696568428056,2,3,4,9,2
3218,355,26,4865.044117783845,1,3,5,9,2
3219,142,8,261.8376706972456,4,1,1,6,3
3220,291,34,195.741198596082,2,4,1,7,2
3221,237,18,4470.3548006913015,2,2,5,9,2
3222,340,31,4490.023844786046,1,4,5,10,1
3223,312,27,544.532717588533,1,3,1,5,3
3224,177,16,1793.655784853934,3,2,2,7,2
3225,141,10,4178.6189447831375,4,1,5,10,1
3226,189,40,651.417980733213,3,4,1,8,2
3227,49,12,1344.4660823199433,5,2,2,9,2
3228,302,22,3408.170223921186,1,3,4,8,2
3229,190,16,4909.676281845209,3,2,5,10,1
3230,136,12,3987.7228119512574,4,2,4,10,1
3231,43,11,3888.814937843793,5,2,4,11,1
3232,353,20,1719.8866918187728,1,2,2,5,3
3233,90,1,3310.1019276406564,4,1,4,9,2
3234,295,27,574.3105617648317,1,3,1,5,3
3235,341,3,4961.4124955856605,1,1,5,7,2
3236,245,12,2408.1157455924113,2,2,3,7,2
3237,192,30,3197.651262639248,3,3,4,10,1
3238,318,9,4382.097774420454,1,1,5,7,2
3239,106,37,14.815159599384273,4,4,1,9,2
3240,363,1,4880.152313705577,1,1,5,7,2
3241,310,42,1802.204967729264,1,5,2,8,2
3242,233,49,1704.5577995651734,2,5,2,9,2
3243,265,4,733.8660471023428,2,1,1,4,3
3244,344,15,4292.34020731487,1,2,5,8,2
3245,37,27,4355.48928397753,5,3,5,13,0
3246,305,8,109.74510473500239,1,1,1,3,3
3247,41,23,288.0688521578485,5,3,1,9,2
3248,17,15,4592.524886562016,5,2,5,12,1
3249,344,27,623.1119800642338,1,3,1,5,3
3250,277,31,3108.428045195125,2,4,4,10,1
3251,307,39,3102.0557463398964,1,4,4,9,2
3252,59,47,4349.954372192185,5,5,5,15,0
3253,183,8,2867.5439860741353,3,1,3,7,2
3254,41,30,2175.7169424400377,5,3,3,11,1
3255,39,42,4872.160105129317,5,5,5,15,0
3256,192,18,1151.7892252348604,3,2,2,7,2
3257,267,4,1320.9629082390845,2,1,2,5,3
3258,147,47,433.00057744505386,3,5,1,9,2
3259,333,43,4876.830917603172,1,5,5,11,1
3260,127,22,3534.7374420997007,4,3,4,11,1
3261,46,3,70.36446658209118,5,1,1,7,2
3262,45,15,3524.526997619397,5,2,4,11,1
3263,1,35,2026.6391944573245,5,4,3,12,1
3264,168,47,4838.072961759354,3,5,5,13,0
3265,108,38,1394.1636357903412,4,4,2,10,1
3266,19,33,3554.3288301823527,5,4,4,13,0
3267,332,14,3140.8964103682347,1,2,4,7,2
3268,72,48,70.12937473228104,5,5,1,11,1
3269,109,1,4427.232477368544,4,1,5,10,1
3270,268,49,706.6671751613028,2,5,1,8,2
3271,240,26,3321.308007199187,2,3,4,9,2
3272,301,8,3879.9867694635022,1,1,4,6,3
3273,90,16,3158.3289560273206,4,2,4,10,1
3274,103,38,494.598198893158,4,4,1,9,2
3275,250,10,4876.143889910909,2,1,5,8,2
3276,8,42,1191.7213934608997,5,5,2,12,1
3277,153,37,3143.0452020199064,3,4,4,11,1
3278,347,26,3987.9185107239427,1,3,4,8,2
3279,174,28,4696.787689433493,3,3,5,11,1
3280,343,12,3024.01254098698,1,2,3,6,3
3281,158,20,1302.680204323947,3,2,2,7,2
3282,215,49,4184.828696860763,3,5,5,13,0
3283,177,14,824.4676300908567,3,2,1,6,3
3284,175,46,121.18931607464236,3,5,1,9,2
3285,340,35,4541.662803627584,1,4,5,10,1
3286,338,29,2881.190900692484,1,3,3,7,2
3287,146,12,357.51103914848005,4,2,1,7,2
3288,324,18,2902.8496417437964,1,2,3,6,3
3289,161,44,733.6206999290187,3,5,1,9,2
3290,127,2,166.61617192035666,4,1,1,6,3
3291,82,2,591.4549969788634,4,1,1,6,3
3292,147,17,3877.7860682447917,3,2,4,9,2
3293,239,10,3780.7479150198633,2,1,4,7,2
3294,84,18,3025.547493227263,4,2,3,9,2
3295,113,22,1054.5481666649005,4,3,2,9,2
3296,225,19,3697.4456583185897,2,2,4,8,2
3297,332,1,2046.1458834031873,1,1,3,5,3
3298,243,24,2558.660549460437,2,3,3,8,2
3299,143,36,4489.2270596983435,4,4,5,13,0
3300,41,25,2294.7090434532456,5,3,3,11,1
3301,258,36,3135.567107718938,2,4,4,10,1
3302,285,31,4809.139944271161,2,4,5,11,1
3303,105,31,2262.435595181647,4,4,3,11,1
3304,202,2,2808.032211981524,3,1,3,7,2
3305,307,19,2926.2289781684053,1,2,3,6,3
3306,331,12,1211.150678775044,1,2,2,5,3
3307,266,10,3687.2410907919325,2,1,4,7,2
3308,210,31,3635.9187710864994,3,4,4,11,1
3309,51,45,1075.6481400634534,5,5,2,12,1
3310,118,22,76.55684372421797,4,3,1,8,2
3311,201,23,4994.71843713658,3,3,5,11,1
3312,39,23,2912.1227874738415,5,3,3,11,1
3313,28,15,913.3498914562467,5,2,1,8,2
3314,259,26,1424.9917577482502,2,3,2,7,2
3315,84,3,3092.7822906234082,4,1,4,9,2
3316,155,23,696.701749429921,3,3,1,7,2
3317,117,20,196.03037917369275,4,2,1,7,2
3318,2,45,3994.41437392917,5,5,4,14,0
3319,93,40,3582.072759316065,4,4,4,12,1
3320,166,39,1554.9122241835878,3,4,2,9,2
3321,350,8,301.8719751,1,1,1,3,3
3322,296,18,2436.491845131907,1,2,3,6,3
3323,258,41,1388.1695867285391,2,5,2,9,2
3324,81,6,1994.9182943951023,4,1,2,7,2
3325,268,27,1377.1070384142583,2,3,2,7,2
3326,235,36,884.5854234303624,2,4,1,7,2
3327,321,15,1941.0790363135804,1,2,2,5,3
3328,311,37,4824.821676154298,1,4,5,10,1
3329,301,5,1338.4770563797356,1,1,2,4,3
3330,357,39,1686.4735537944528,1,4,2,7,2
3331,213,9,1652.917747287907,3,1,2,6,3
3332,62,7,2406.641210754796,5,1,3,9,2
3333,49,41,4219.09263857599,5,5,5,15,0
3334,127,20,2016.5917318327288,4,2,3,9,2
3335,223,10,4032.678340524879,2,1,5,8,2
3336,279,26,583.9104260683604,2,3,1,6,3
3337,294,4,4475.586951363744,1,1,5,7,2
3338,284,38,934.6673767844335,2,4,1,7,2
3339,277,24,205.615480421812,2,3,1,6,3
3340,107,14,800.1888570815461,4,2,1,7,2
3341,146,41,961.8414585403532,4,5,1,10,1
3342,99,1,2547.4355967906617,4,1,3,8,2
3343,73,17,2255.192080837748,5,2,3,10,1
3344,122,45,3582.213340489226,4,5,4,13,0
3345,30,24,264.2459181103807,5,3,1,9,2
3346,188,27,2493.5541943666617,3,3,3,9,2
3347,364,7,1669.0314223476703,1,1,2,4,3
3348,354,9,3157.224597134132,1,1,4,6,3
3349,288,43,228.061623383842,2,5,1,8,2
3350,195,35,184.32469650161522,3,4,1,8,2
3351,156,12,2141.98549096752,3,2,3,8,2
3352,172,21,4058.5840012155445,3,3,5,11,1
3353,335,3,3358.7593800350205,1,1,4,6,3
3354,41,15,93.3633986387139,5,2,1,8,2
3355,63,21,900.5757501284705,5,3,1,9,2
3356,23,10,1141.3900079420405,5,1,2,8,2
3357,360,33,2121.0640484505216,1,4,3,8,2
3358,75,46,2937.7112627697798,4,5,3,12,1
3359,48,6,1090.1362677474754,5,1,2,8,2
3360,160,2,1918.7459801167654,3,1,2,6,3
3361,313,29,2923.8775360288832,1,3,3,7,2
3362,118,40,1923.3421664692287,4,4,2,10,1
3363,100,33,724.4154127093145,4,4,1,9,2
3364,167,4,2463.389016435736,3,1,3,7,2
3365,290,4,1626.731037809489,2,1,2,5,3
3366,156,29,4322.29992914863,3,3,5,11,1
3367,7,37,3880.3682913882335,5,4,4,13,0
3368,196,20,959.4727102461103,3,2,1,6,3
3369,56,41,771.6525987409134,5,5,1,11,1
3370,321,23,1744.906599839355,1,3,2,6,3
3371,193,45,2066.750757213526,3,5,3,11,1
3372,47,18,4660.770575110393,5,2,5,12,1
3373,148,49,1515.0874780558115,3,5,2,10,1
3374,275,25,4339.245921312773,2,3,5,10,1
3375,157,1,2531.4933039750413,3,1,3,7,2
3376,202,15,4429.262390531374,3,2,5,10,1
3377,126,34,3512.7493488696464,4,4,4,12,1
3378,305,48,3544.860950865751,1,5,4,10,1
3379,294,20,2598.7994626057775,1,2,3,6,3
3380,64,37,4203.117167474918,5,4,5,14,0
3381,325,27,1279.5797781560611,1,3,2,6,3
3382,176,22,4537.682844869177,3,3,5,11,1
3383,116,5,3187.5115166294763,4,1,4,9,2
3384,204,34,2199.1574184477035,3,4,3,10,1
3385,321,39,4911.12761804363,1,4,5,10,1
3386,31,3,4311.4503934890845,5,1,5,11,1
3387,113,17,3862.3848540301806,4,2,4,10,1
3388,325,24,1376.7733306340297,1,3,2,6,3
3389,344,24,4868.966095157664,1,3,5,9,2
3390,67,3,3717.5076391015195,5,1,4,10,1
3391,75,45,3030.0342473049172,4,5,3,12,1
3392,45,7,4609.778152776531,5,1,5,11,1
3393,260,25,819.2865928263546,2,3,1,6,3
3394,154,3,703.690103293741,3,1,1,5,3
3395,155,15,2822.929937809893,3,2,3,8,2
3396,363,29,293.00084719922245,1,3,1,5,3
3397,234,29,3323.2944407164086,2,3,4,9,2
3398,51,10,1211.2982791969428,5,1,2,8,2
3399,306,32,603.9426239359261,1,4,1,6,3
3400,262,23,2053.3842904594753,2,3,3,8,2
3401,315,39,2335.088635564163,1,4,3,8,2
3402,125,9,860.7194708413948,4,1,1,6,3
3403,245,37,217.2610020710996,2,4,1,7,2
3404,30,40,2076.13740028168,5,4,3,12,1
3405,122,14,3800.0364165822652,4,2,4,10,1
3406,125,4,4372.256855299098,4,1,5,10,1
3407,37,20,496.76598770420753,5,2,1,8,2
3408,170,28,2628.130560426163,3,3,3,9,2
3409,124,14,1324.38091414386,4,2,2,8,2
3410,357,44,1879.4230093183037,1,5,2,8,2
3411,35,34,4667.874730501933,5,4,5,14,0
3412,87,13,1766.8531169987782,4,2,2,8,2
3413,134,31,1833.0761915898509,4,4,2,10,1
3414,196,33,1054.8851704675064,3,4,2,9,2
3415,274,39,4800.491905949019,2,4,5,11,1
3416,201,28,2287.871909734814,3,3,3,9,2
3417,285,25,2856.256748943247,2,3,3,8,2
3418,77,32,2271.308780583985,4,4,3,11,1
3419,59,9,1272.0661930516821,5,1,2,8,2
3420,126,28,4053.9589395735247,4,3,5,12,1
3421,109,31,152.07141712533758,4,4,1,9,2
3422,224,17,3454.3147161575516,2,2,4,8,2
3423,278,23,2975.4213248907686,2,3,3,8,2
3424,68,13,729.9604469368584,5,2,1,8,2
3425,69,10,837.8661710604403,5,1,1,7,2
3426,165,16,3299.535683625338,3,2,4,9,2
3427,305,6,1567.5725703997248,1,1,2,4,3
3428,162,48,1336.033010046739,3,5,2,10,1
3429,342,11,305.1889167310237,1,2,1,4,3
3430,309,3,3834.750615720693,1,1,4,6,3
3431,343,28,4414.532957150221,1,3,5,9,2
3432,42,41,4101.023315111412,5,5,5,15,0
3433,354,15,2335.510256305184,1,2,3,6,3
3434,109,13,2674.4424788170068,4,2,3,9,2
3435,51,42,1218.958207983595,5,5,2,12,1
3436,250,45,872.5451496997429,2,5,1,8,2
3437,341,17,4116.77586270781,1,2,5,8,2
3438,21,7,3993.737361118703,5,1,4,10,1
3439,300,28,3889.025543900091,1,3,4,8,2
3440,139,38,2322.1629389241975,4,4,3,11,1
3441,359,13,4323.89372661435,1,2,5,8,2
3442,324,17,4631.898026060565,1,2,5,8,2
3443,92,15,1648.4382798206893,4,2,2,8,2
3444,280,36,1131.2255139839756,2,4,2,8,2
3445,125,28,2326.672523572156,4,3,3,10,1
3446,111,15,904.8385198062166,4,2,1,7,2
3447,354,46,4421.174396848085,1,5,5,11,1
3448,139,11,1696.5725953880694,4,2,2,8,2
3449,273,31,2885.097214837478,2,4,3,9,2
3450,99,4,2977.650284576554,4,1,3,8,2
3451,252,35,2579.789522926023,2,4,3,9,2
3452,338,34,791.0632900212605,1,4,1,6,3
3453,104,27,4955.093194065923,4,3,5,12,1
3454,214,10,871.2901139132372,3,1,1,5,3
3455,249,30,3760.02172924884,2,3,4,9,2
3456,152,45,3958.9007415352435,3,5,4,12,1
3457,250,20,734.3669047227506,2,2,1,5,3
3458,275,29,4666.485922633903,2,3,5,10,1
3459,165,29,2443.9162255123642,3,3,3,9,2
3460,341,23,3148.1259632527563,1,3,4,8,2
3461,8,21,3214.5084196136327,5,3,4,12,1
3462,284,48,2529.7260767055805,2,5,3,10,1
3463,5,43,718.690000164557,5,5,1,11,1
3464,145,10,3761.249255877583,4,1,4,9,2
3465,101,41,2913.1113172662263,4,5,3,12,1
3466,164,12,602.2162701343436,3,2,1,6,3
3467,147,30,3504.606623481707,3,3,4,10,1
3468,64,33,3516.7886714243878,5,4,4,13,0
3469,91,18,2746.9473660186163,4,2,3,9,2
3470,117,14,461.8385633549245,4,2,1,7,2
3471,354,22,1769.693715372279,1,3,2,6,3
3472,267,21,264.11129705723783,2,3,1,6,3
3473,310,1,2393.204133943693,1,1,3,5,3
3474,173,49,4533.1711881512765,3,5,5,13,0
3475,47,43,21.242383238489396,5,5,1,11,1
3476,140,15,1340.5268786816368,4,2,2,8,2
3477,246,36,4001.296914728944,2,4,4,10,1
3478,149,47,59.20556076981653,3,5,1,9,2
3479,246,22,60.76545085957346,2,3,1,6,3
3480,5,32,3057.9847446110516,5,4,4,13,0
3481,184,46,3948.106786424936,3,5,4,12,1
3482,20,33,3884.762033158687,5,4,4,13,0
3483,46,41,3900.094323538942,5,5,4,14,0
3484,12,39,1811.421660640152,5,4,2,11,1
3485,70,23,4414.793479929549,5,3,5,13,0
3486,17,43,74.0496509697171,5,5,1,11,1
3487,147,2,1567.821796493779,3,1,2,6,3
3488,154,2,1692.5665972285956,3,1,2,6,3
3489,304,38,836.1999178395102,1,4,1,6,3
3490,108,29,1687.767605230575,4,3,2,9,2
3491,236,46,2933.5618089600243,2,5,3,10,1
3492,308,3,2606.1937703599388,1,1,3,5,3
3493,352,39,1603.9425193368538,1,4,2,7,2
3494,70,7,3749.144293275453,5,1,4,10,1
3495,183,36,3576.804986404658,3,4,4,11,1
3496,250,29,1410.6754206313979,2,3,2,7,2
3497,228,37,1622.9096799618083,2,4,2,8,2
3498,102,49,1444.7257911743168,4,5,2,11,1
3499,75,36,652.9673208909655,4,4,1,9,2
3500,216,23,3766.3803983746657,3,3,4,10,1
3501,203,45,240.9197874710928,3,5,1,9,2
3502,192,16,761.3966655760796,3,2,1,6,3
3503,249,48,535.4695435617587,2,5,1,8,2
3504,242,31,4128.441487866428,2,4,5,11,1
3505,179,34,229.60249177988743,3,4,1,8,2
3506,219,1,3326.4901766836288,2,1,4,7,2
3507,82,18,231.92824606990936,4,2,1,7,2
3508,92,40,3934.3525855697785,4,4,4,12,1
3509,175,43,4564.443291104805,3,5,5,13,0
3510,239,15,2439.3473975144616,2,2,3,7,2
3511,260,48,4024.6635870513555,2,5,5,12,1
3512,163,49,3534.9885589226396,3,5,4,12,1
3513,48,17,3980.2201079456013,5,2,4,11,1
3514,329,44,3836.2082456346825,1,5,4,10,1
3515,328,10,1034.7857398562724,1,1,2,4,3
3516,116,20,2502.7994606723996,4,2,3,9,2
3517,337,6,4802.4667937606655,1,1,5,7,2
3518,337,8,1724.2293934616432,1,1,2,4,3
3519,225,45,4852.730582278951,2,5,5,12,1
3520,352,34,2919.976940054342,1,4,3,8,2
3521,328,32,2313.440974152229,1,4,3,8,2
3522,147,42,3292.209750480749,3,5,4,12,1
3523,63,4,4081.037464176691,5,1,5,11,1
3524,294,44,1977.0986927052386,1,5,2,8,2
3525,323,39,174.44133382204333,1,4,1,6,3
3526,325,20,3546.943426872353,1,2,4,7,2
3527,13,24,4781.272254641952,5,3,5,13,0
3528,189,24,3128.683384878927,3,3,4,10,1
3529,287,26,950.1882479419119,2,3,1,6,3
3530,208,25,1248.7302355837408,3,3,2,8,2
3531,114,36,4549.656085970558,4,4,5,13,0
3532,22,7,77.67485706630848,5,1,1,7,2
3533,349,10,2748.245860662453,1,1,3,5,3
3534,214,47,801.8014495178393,3,5,1,9,2
3535,171,12,1420.9945317332263,3,2,2,7,2
3536,323,1,1541.838430971368,1,1,2,4,3
3537,54,25,1104.2209112142546,5,3,2,10,1
3538,298,16,3963.836792903717,1,2,4,7,2
3539,320,5,1667.7237781540066,1,1,2,4,3
3540,126,19,1733.9701064150347,4,2,2,8,2
3541,277,4,2270.5040003303607,2,1,3,6,3
3542,204,6,4512.453490814709,3,1,5,9,2
3543,194,26,3443.983429813148,3,3,4,10,1
3544,169,49,318.13102379721073,3,5,1,9,2
3545,152,39,205.91698597250482,3,4,1,8,2
3546,35,39,2836.2822555893567,5,4,3,12,1
3547,184,9,4436.432203018767,3,1,5,9,2
3548,286,45,1623.0248652429498,2,5,2,9,2
3549,57,14,1246.3814262218204,5,2,2,9,2
3550,222,48,3743.473316112265,2,5,4,11,1
3551,303,9,3014.435918684439,1,1,3,5,3
3552,163,15,2829.486438360457,3,2,3,8,2
3553,19,37,755.0129837262701,5,4,1,10,1
3554,264,20,888.0469801183183,2,2,1,5,3
3555,282,8,1416.121001860881,2,1,2,5,3
3556,113,32,1042.1262840628654,4,4,2,10,1
3557,327,47,4857.509277781716,1,5,5,11,1
3558,30,21,102.86897161722523,5,3,1,9,2
3559,135,41,3134.021128762327,4,5,4,13,0
3560,67,19,2592.818136128437,5,2,3,10,1
3561,65,29,1623.023667133197,5,3,2,10,1
3562,292,31,4439.0676733988375,1,4,5,10,1
3563,25,6,3354.111261921018,5,1,4,10,1
3564,37,4,4991.7882131029,5,1,5,11,1
3565,1,43,851.593237039162,5,5,1,11,1
3566,37,29,448.4605009804655,5,3,1,9,2
3567,141,42,705.5923646570564,4,5,1,10,1
3568,232,3,1353.7619282471353,2,1,2,5,3
3569,136,1,2089.767087924101,4,1,3,8,2
3570,188,44,4314.390392159696,3,5,5,13,0
3571,128,15,1425.1229139811442,4,2,2,8,2
3572,201,47,4577.064117038134,3,5,5,13,0
3573,127,21,2319.909365139536,4,3,3,10,1
3574,257,46,3238.8793925095233,2,5,4,11,1
3575,164,31,1329.3944931391943,3,4,2,9,2
3576,35,7,788.5089419574542,5,1,1,7,2
3577,194,17,4348.590133883666,3,2,5,10,1
3578,191,19,556.435840795618,3,2,1,6,3
3579,104,39,3872.366315777443,4,4,4,12,1
3580,23,3,2909.1116873235187,5,1,3,9,2
3581,265,30,4307.077530577456,2,3,5,10,1
3582,290,35,3591.913876369904,2,4,4,10,1
3583,260,29,1415.5038695365936,2,3,2,7,2
3584,358,14,2876.3937103138082,1,2,3,6,3
3585,75,35,75.23736183118194,4,4,1,9,2
3586,355,28,2381.3395284384205,1,3,3,7,2
3587,72,30,439.20804150445804,5,3,1,9,2
3588,259,26,2150.435539073545,2,3,3,8,2
3589,188,7,556.9629219133992,3,1,1,5,3
3590,173,39,4777.844236657621,3,4,5,12,1
3591,290,31,2620.109107464562,2,4,3,9,2
3592,45,5,4566.95774653045,5,1,5,11,1
3593,61,35,121.60745259917158,5,4,1,10,1
3594,83,47,3191.8898865706706,4,5,4,13,0
3595,123,14,1541.7029646138349,4,2,2,8,2
3596,358,36,2164.826689866529,1,4,3,8,2
3597,16,27,4366.706102121301,5,3,5,13,0
3598,66,24,4900.305262846136,5,3,5,13,0
3599,145,40,1239.9948526224284,4,4,2,10,1
3600,162,29,4741.783893912975,3,3,5,11,1
3601,234,45,3446.7474749197786,2,5,4,11,1
3602,144,22,4757.555432642781,4,3,5,12,1
3603,358,8,2816.2113231198377,1,1,3,5,3
3604,188,15,4804.173862107438,3,2,5,10,1
3605,322,49,4463.3527361556935,1,5,5,11,1
3606,13,5,651.6727887149757,5,1,1,7,2
3607,184,4,1560.8417362376351,3,1,2,6,3
3608,111,11,1222.8853256474342,4,2,2,8,2
3609,290,18,2864.7756369907825,2,2,3,7,2
3610,295,42,4015.969163214567,1,5,5,11,1
3611,215,49,3799.4631199655373,3,5,4,12,1
3612,120,30,3636.4781700945487,4,3,4,11,1
3613,55,15,1882.5717299205735,5,2,2,9,2
3614,27,6,706.7880393228614,5,1,1,7,2
3615,118,16,1060.8119326067103,4,2,2,8,2
3616,221,47,3710.97052364518,2,5,4,11,1
3617,231,40,746.1963519072207,2,4,1,7,2
3618,53,9,1122.5040576182703,5,1,2,8,2
3619,295,43,2128.517737838721,1,5,3,9,2
3620,321,34,369.8410291304403,1,4,1,6,3
3621,233,27,1071.3333832429478,2,3,2,7,2
3622,158,13,757.3429554327705,3,2,1,6,3
3623,269,36,4757.095696730084,2,4,5,11,1
3624,21,27,965.7141688689968,5,3,1,9,2
3625,53,9,4310.230853750265,5,1,5,11,1
3626,275,5,582.8429744203759,2,1,1,4,3
3627,313,22,4349.668930189511,1,3,5,9,2
3628,281,31,3001.1745935046138,2,4,3,9,2
3629,214,3,4250.032556890844,3,1,5,9,2
3630,31,30,4338.069955801414,5,3,5,13,0
3631,337,21,2985.903918030371,1,3,3,7,2
3632,183,35,4589.29382544117,3,4,5,12,1
3633,23,6,2931.3869745082684,5,1,3,9,2
3634,32,28,3565.699738613093,5,3,4,12,1
3635,74,32,2086.241581072475,4,4,3,11,1
3636,10,42,4571.197795410227,5,5,5,15,0
3637,54,37,4122.571069171013,5,4,5,14,0
3638,52,25,841.8984269684681,5,3,1,9,2
3639,148,32,2886.1753725214467,3,4,3,10,1
3640,160,35,4485.168372143862,3,4,5,12,1
3641,14,22,3967.3918233581653,5,3,4,12,1
3642,178,24,4813.1383755000115,3,3,5,11,1
3643,53,39,1164.195417868498,5,4,2,11,1
3644,335,30,1843.6235693210854,1,3,2,6,3
3645,22,32,2540.8875212104754,5,4,3,12,1
3646,30,31,1171.019158436052,5,4,2,11,1
3647,191,23,1976.285823392207,3,3,2,8,2
3648,260,40,2692.320630077419,2,4,3,9,2
3649,205,33,964.7826229766899,3,4,1,8,2
3650,59,25,1290.8722153258773,5,3,2,10,1
3651,264,36,632.9640740458844,2,4,1,7,2
3652,12,24,3569.773235329885,5,3,4,12,1
3653,119,31,1814.1441134153035,4,4,2,10,1
3654,290,39,1109.128104387104,2,4,2,8,2
3655,338,46,2541.547504412953,1,5,3,9,2
3656,248,13,350.5640353693859,2,2,1,5,3
3657,354,10,4617.79896552879,1,1,5,7,2
3658,127,23,1479.3929305747488,4,3,2,9,2
3659,75,18,4433.457097437472,4,2,5,11,1
3660,361,32,2493.124125969988,1,4,3,8,2
3661,204,33,4252.250983576097,3,4,5,12,1
3662,49,36,1242.8515595403262,5,4,2,11,1
3663,79,28,884.6003051913376,4,3,1,8,2
3664,241,16,4248.5648981417935,2,2,5,9,2
3665,349,16,1072.4901730348374,1,2,2,5,3
3666,154,18,3733.5147930049047,3,2,4,9,2
3667,274,8,1729.4731353515656,2,1,2,5,3
3668,96,42,3743.4866949114553,4,5,4,13,0
3669,214,16,4539.154867281768,3,2,5,10,1
3670,294,11,4908.3757721235925,1,2,5,8,2
3671,209,6,1805.449291570481,3,1,2,6,3
3672,343,1,1843.9539148563256,1,1,2,4,3
3673,88,12,4907.124806556424,4,2,5,11,1
3674,306,38,4309.025370187212,1,4,5,10,1
3675,264,28,235.0089398377764,2,3,1,6,3
3676,325,45,2871.515431270337,1,5,3,9,2
3677,320,17,914.4114100267072,1,2,1,4,3
3678,157,1,4970.12255510516,3,1,5,9,2
3679,156,32,703.2258317311588,3,4,1,8,2
3680,139,8,2801.144586588904,4,1,3,8,2
3681,121,40,3329.339866445624,4,4,4,12,1
3682,65,43,4685.952626723741,5,5,5,15,0
3683,107,46,4237.818975104493,4,5,5,14,0
3684,147,24,1236.3163089256373,3,3,2,8,2
3685,137,10,2867.3935169495976,4,1,3,8,2
3686,162,47,4768.334049950357,3,5,5,13,0
3687,100,39,3681.227067053639,4,4,4,12,1
3688,338,39,3444.79837841567,1,4,4,9,2
3689,307,10,3776.956385612971,1,1,4,6,3
3690,141,36,1619.3058830492207,4,4,2,10,1
3691,83,25,3648.9688243221485,4,3,4,11,1
3692,177,10,1171.9452097201104,3,1,2,6,3
3693,198,19,2146.2328268296897,3,2,3,8,2
3694,112,46,4450.744797770647,4,5,5,14,0
3695,56,45,104.66602098885105,5,5,1,11,1
3696,179,15,2077.45006475921,3,2,3,8,2
3697,186,16,1341.4406160279073,3,2,2,7,2
3698,218,2,1000.9621863031109,2,1,1,4,3
3699,316,29,4194.491353147836,1,3,5,9,2
3700,217,4,3485.5278784964407,3,1,4,8,2
3701,120,29,572.037274853294,4,3,1,8,2
3702,175,31,2477.371999240935,3,4,3,10,1
3703,23,17,2339.8598014172844,5,2,3,10,1
3704,213,10,721.2136922067485,3,1,1,5,3
3705,235,27,4000.815877946129,2,3,4,9,2
3706,13,41,1839.7031175564568,5,5,2,12,1
3707,101,15,3812.069498050368,4,2,4,10,1
3708,24,44,968.3924492602401,5,5,1,11,1
3709,364,31,1582.2165734530233,1,4,2,7,2
3710,11,21,484.9030290363027,5,3,1,9,2
3711,273,41,725.9615560305849,2,5,1,8,2
3712,281,46,4417.085616860138,2,5,5,12,1
3713,94,45,554.4720944860319,4,5,1,10,1
3714,201,26,487.6987243568566,3,3,1,7,2
3715,21,38,4702.482781074933,5,4,5,14,0
3716,340,36,3233.0582637072303,1,4,4,9,2
3717,211,17,513.570757936553,3,2,1,6,3
3718,140,3,4858.866527939596,4,1,5,10,1
3719,293,14,744.0290524114527,1,2,1,4,3
3720,298,49,3834.0651691742855,1,5,4,10,1
3721,101,13,183.90829458153647,4,2,1,7,2
3722,304,41,3126.4635687256596,1,5,4,10,1
3723,359,27,2738.05232179345,1,3,3,7,2
3724,28,1,1047.9390140222526,5,1,2,8,2
3725,41,17,3219.299252174877,5,2,4,11,1
3726,355,48,3089.094435955169,1,5,4,10,1
3727,303,34,3993.775060165244,1,4,4,9,2
3728,146,14,4380.611552416222,4,2,5,11,1
3729,256,17,2555.4236538612945,2,2,3,7,2
3730,227,3,2456.573015485965,2,1,3,6,3
3731,236,34,3111.7628970140418,2,4,4,10,1
3732,361,40,3648.7458702567674,1,4,4,9,2
3733,13,25,1787.2941504849541,5,3,2,10,1
3734,210,2,2528.1629979974796,3,1,3,7,2
3735,229,34,2929.669887257635,2,4,3,9,2
3736,100,26,4942.006638341196,4,3,5,12,1
3737,31,31,2942.683860315024,5,4,3,12,1
3738,16,9,1128.6908882038608,5,1,2,8,2
3739,137,30,2944.069392618901,4,3,3,10,1
3740,329,20,4099.3029189156005,1,2,5,8,2
3741,166,21,4288.444363255842,3,3,5,11,1
3742,310,29,4003.2497684191285,1,3,4,8,2
3743,100,25,4442.164982291321,4,3,5,12,1
3744,109,38,1680.4840459768461,4,4,2,10,1
3745,343,44,2542.7773985537838,1,5,3,9,2
3746,173,25,3900.1595690776444,3,3,4,10,1
3747,237,9,1329.6052542879008,2,1,2,5,3
3748,162,39,1864.1913748799882,3,4,2,9,2
3749,216,44,4157.4667162345,3,5,5,13,0
3750,264,26,3852.7273916062113,2,3,4,9,2
3751,263,37,4856.285843901284,2,4,5,11,1
3752,292,16,4979.910551988104,1,2,5,8,2
3753,274,37,1211.3152893871813,2,4,2,8,2
3754,3,12,4503.24543100663,5,2,5,12,1
3755,28,24,481.632351736845,5,3,1,9,2
3756,326,26,3551.903042730637,1,3,4,8,2
3757,149,20,1108.2959445009992,3,2,2,7,2
3758,28,9,1508.552673043588,5,1,2,8,2
3759,310,23,4732.142676546064,1,3,5,9,2
3760,65,39,1323.1246713037176,5,4,2,11,1
3761,356,29,3369.157567111545,1,3,4,8,2
3762,21,31,898.8612542376484,5,4,1,10,1
3763,252,19,476.0159880767332,2,2,1,5,3
3764,235,20,1703.1919564658835,2,2,2,6,3
3765,227,23,3124.7385429395117,2,3,4,9,2
3766,13,43,1247.246267332865,5,5,2,12,1
3767,313,27,1507.8423053716533,1,3,2,6,3
3768,49,30,3546.561794846211,5,3,4,12,1
3769,118,21,522.9521546770314,4,3,1,8,2
3770,54,44,2240.0564080995023,5,5,3,13,0
3771,138,35,4709.255304112298,4,4,5,13,0
3772,53,49,1990.8885954469827,5,5,2,12,1
3773,44,7,2176.663129607422,5,1,3,9,2
3774,303,22,3693.639475000372,1,3,4,8,2
3775,53,10,3897.2674949439056,5,1,4,10,1
3776,74,23,3850.3358850048176,4,3,4,11,1
3777,46,15,4989.356454318725,5,2,5,12,1
3778,13,30,366.540926560416,5,3,1,9,2
3779,165,34,4911.4438903186665,3,4,5,12,1
3780,102,13,4751.44618881702,4,2,5,11,1
3781,280,4,4262.173112295195,2,1,5,8,2
3782,258,18,2276.0866235016883,2,2,3,7,2
3783,337,23,4355.802834453282,1,3,5,9,2
3784,356,33,1111.953737407415,1,4,2,7,2
3785,138,34,3960.3626185852727,4,4,4,12,1
3786,163,34,934.3391325740603,3,4,1,8,2
3787,111,36,4078.656397321187,4,4,5,13,0
3788,102,35,3076.5003749876437,4,4,4,12,1
3789,17,17,499.1760847724924,5,2,1,8,2
3790,268,28,4477.644581232555,2,3,5,10,1
3791,182,14,2894.0064053216693,3,2,3,8,2
3792,24,34,3284.678907904202,5,4,4,13,0
3793,29,48,1424.7150779015342,5,5,2,12,1
3794,171,11,4359.461164574805,3,2,5,10,1
3795,228,13,2730.5516684162817,2,2,3,7,2
3796,188,33,2111.3902186146024,3,4,3,10,1
3797,346,2,2676.0659086893043,1,1,3,5,3
3798,230,34,3519.5322765242054,2,4,4,10,1
3799,321,29,3478.2888997393575,1,3,4,8,2
3800,340,37,1794.3097337794854,1,4,2,7,2
3801,119,4,1932.4388177302399,4,1,2,7,2
3802,156,12,2815.5685822637515,3,2,3,8,2
3803,272,26,4622.79153237777,2,3,5,10,1
3804,175,28,3729.6970321602175,3,3,4,10,1
3805,104,3,1958.1707769741276,4,1,2,7,2
3806,92,20,1691.792806493288,4,2,2,8,2
3807,186,10,2622.9470039451994,3,1,3,7,2
3808,283,18,4351.256930883827,2,2,5,9,2
3809,181,27,53.30941556341718,3,3,1,7,2
3810,170,31,3555.3254807649246,3,4,4,11,1
3811,187,27,1479.616154634457,3,3,2,8,2
3812,175,42,1049.9034262786877,3,5,2,10,1
3813,222,1,70.56860411562675,2,1,1,4,3
3814,233,6,4483.98719692113,2,1,5,8,2
3815,162,11,4562.119865332139,3,2,5,10,1
3816,134,34,316.4730338026624,4,4,1,9,2
3817,224,39,2613.858462026289,2,4,3,9,2
3818,153,20,771.3465487813132,3,2,1,6,3
3819,33,21,3795.850897694888,5,3,4,12,1
3820,55,21,3330.303444113073,5,3,4,12,1
3821,7,18,1492.6827566461702,5,2,2,9,2
3822,244,21,593.6318023914232,2,3,1,6,3
3823,313,19,4157.791107408869,1,2,5,8,2
3824,126,4,3374.5198716314067,4,1,4,9,2
3825,12,13,44.031525562738395,5,2,1,8,2
3826,16,18,3143.0801868711656,5,2,4,11,1
3827,208,29,4053.377178204766,3,3,5,11,1
3828,43,25,2957.9326172866495,5,3,3,11,1
3829,135,13,2129.321246616831,4,2,3,9,2
3830,228,27,2923.7527089261516,2,3,3,8,2
3831,111,19,3102.363163169263,4,2,4,10,1
3832,307,49,3203.772773471233,1,5,4,10,1
3833,160,1,4835.554818982774,3,1,5,9,2
3834,331,38,901.452459916208,1,4,1,6,3
3835,264,19,3119.2347052963896,2,2,4,8,2
3836,225,1,948.0866649521255,2,1,1,4,3
3837,217,40,1057.6840340425688,3,4,2,9,2
3838,45,17,3349.5968396997605,5,2,4,11,1
3839,214,21,4580.610884010194,3,3,5,11,1
3840,59,22,803.6307930252156,5,3,1,9,2
3841,132,15,4812.703013444566,4,2,5,11,1
3842,104,39,1603.6679068209828,4,4,2,10,1
3843,195,48,1962.6570768494325,3,5,2,10,1
3844,157,39,776.8673114547993,3,4,1,8,2
3845,98,32,3083.0221681997355,4,4,4,12,1
3846,226,49,2986.1382681735968,2,5,3,10,1
3847,205,4,2216.92601808222,3,1,3,7,2
3848,79,44,2385.696035522836,4,5,3,12,1
3849,124,45,3118.649620176585,4,5,4,13,0
3850,218,32,2921.647709472148,2,4,3,9,2
3851,4,4,1877.5742744255735,5,1,2,8,2
3852,90,1,4421.730782646335,4,1,5,10,1
3853,104,33,3341.6260104055063,4,4,4,12,1
3854,119,7,1034.9775896930455,4,1,2,7,2
3855,133,9,1606.3159375935795,4,1,2,7,2
3856,312,1,3941.5117274992353,1,1,4,6,3
3857,96,16,531.5816512902962,4,2,1,7,2
3858,331,18,3753.6576736342417,1,2,4,7,2
3859,143,47,1800.6237813175187,4,5,2,11,1
3860,288,6,2762.9383200810935,2,1,3,6,3
3861,28,2,1409.9850046924698,5,1,2,8,2
3862,278,9,4932.418293383935,2,1,5,8,2
3863,233,4,4530.143057790098,2,1,5,8,2
3864,17,45,4642.964686351816,5,5,5,15,0
3865,59,23,932.0298347078083,5,3,1,9,2
3866,90,43,4210.033578849208,4,5,5,14,0
3867,199,45,2681.6315341102104,3,5,3,11,1
3868,362,43,3542.217409365457,1,5,4,10,1
3869,26,8,1095.3452930348276,5,1,2,8,2
3870,25,39,3562.8033834362877,5,4,4,13,0
3871,301,25,4572.193550415757,1,3,5,9,2
3872,339,16,1344.7321153855114,1,2,2,5,3
3873,267,35,1174.4656592320378,2,4,2,8,2
3874,181,17,531.028596882654,3,2,1,6,3
3875,360,18,1341.3653098051884,1,2,2,5,3
3876,68,27,2683.6033864599062,5,3,3,11,1
3877,351,15,4165.254294273426,1,2,5,8,2
3878,321,17,1401.2133106616209,1,2,2,5,3
3879,49,43,3109.510501455874,5,5,4,14,0
3880,175,5,2403.1575888734687,3,1,3,7,2
3881,52,16,1450.0094126826805,5,2,2,9,2
3882,102,15,2556.69181516129,4,2,3,9,2
3883,216,42,848.1323580154271,3,5,1,9,2
3884,188,46,3201.4920236441058,3,5,4,12,1
3885,57,34,587.1569787074149,5,4,1,10,1
3886,47,48,3657.592820464708,5,5,4,14,0
3887,159,19,896.7862651436809,3,2,1,6,3
3888,174,8,4990.81417505119,3,1,5,9,2
3889,242,47,4120.126247854456,2,5,5,12,1
3890,282,10,1725.7631162600144,2,1,2,5,3
3891,241,5,2136.761813723668,2,1,3,6,3
3892,5,48,1303.3631953273652,5,5,2,12,1
3893,84,26,3837.901660288196,4,3,4,11,1
3894,308,22,1909.8275800892923,1,3,2,6,3
3895,361,44,3778.3756939994832,1,5,4,10,1
3896,248,23,101.82375785410102,2,3,1,6,3
3897,54,13,686.7485879279327,5,2,1,8,2
3898,161,9,1831.2219301658172,3,1,2,6,3
3899,226,49,553.4535816390177,2,5,1,8,2
3900,15,20,3009.6286815582416,5,2,3,10,1
3901,224,28,263.6521716852752,2,3,1,6,3
3902,61,44,4300.2173430008215,5,5,5,15,0
3903,122,37,3808.9269137923525,4,4,4,12,1
3904,277,24,1089.1198313474827,2,3,2,7,2
3905,46,44,2424.1216115872917,5,5,3,13,0
3906,294,33,2264.5472612704934,1,4,3,8,2
3907,62,20,3627.074430548485,5,2,4,11,1
3908,86,48,2013.5294133677996,4,5,3,12,1
3909,210,30,174.34713617093016,3,3,1,7,2
3910,78,44,1375.9419356606948,4,5,2,11,1
3911,202,9,2336.3170681328397,3,1,3,7,2
3912,302,45,4872.716158641589,1,5,5,11,1
3913,223,49,4406.981748102183,2,5,5,12,1
3914,222,17,915.2166585709303,2,2,1,5,3
3915,3,36,3619.1469430489474,5,4,4,13,0
3916,6,14,4684.75911034379,5,2,5,12,1
3917,93,19,53.87513904594031,4,2,1,7,2
3918,8,7,3607.5189116174215,5,1,4,10,1
3919,235,3,2302.074143099675,2,1,3,6,3
3920,108,33,3404.3786194527247,4,4,4,12,1
3921,161,44,3031.8904751232335,3,5,3,11,1
3922,209,32,4923.480817333951,3,4,5,12,1
3923,240,47,1451.1888774263605,2,5,2,9,2
3924,331,11,3932.8534795276314,1,2,4,7,2
3925,333,42,1180.853042682175,1,5,2,8,2
3926,50,2,2183.683807975363,5,1,3,9,2
3927,11,26,4877.1505610973845,5,3,5,13,0
3928,351,4,3833.0201171106214,1,1,4,6,3
3929,156,17,1585.9480688549597,3,2,2,7,2
3930,70,17,3100.6527226288304,5,2,4,11,1
3931,169,28,257.96349667884715,3,3,1,7,2
3932,272,30,1339.3106339386388,2,3,2,7,2
3933,68,40,3594.7685431220366,5,4,4,13,0
3934,355,23,2854.7669122457414,1,3,3,7,2
3935,252,46,2353.667536354094,2,5,3,10,1
3936,48,24,3457.4715394796563,5,3,4,12,1
3937,184,29,1998.3098651909318,3,3,2,8,2
3938,320,4,140.5191612167414,1,1,1,3,3
3939,187,38,2210.7228513426808,3,4,3,10,1
3940,90,29,4511.624669543376,4,3,5,12,1
3941,332,19,4284.509490287465,1,2,5,8,2
3942,139,27,2050.8959551934695,4,3,3,10,1
3943,357,29,120.88498939430959,1,3,1,5,3
3944,89,36,3185.1732903753755,4,4,4,12,1
3945,274,35,3708.5601946364945,2,4,4,10,1
3946,19,6,1478.2754446605315,5,1,2,8,2
3947,311,23,2388.5533581016757,1,3,3,7,2
3948,358,39,4959.365408286065,1,4,5,10,1
3949,154,46,2885.9516347781773,3,5,3,11,1
3950,260,44,1761.8637792512175,2,5,2,9,2
3951,108,48,3141.169494434264,4,5,4,13,0
3952,285,8,908.3113112517816,2,1,1,4,3
3953,59,2,1004.2693426401543,5,1,1,7,2
3954,125,13,4625.374326422944,4,2,5,11,1
3955,354,40,1203.6082054349602,1,4,2,7,2
3956,273,21,1560.839002286563,2,3,2,7,2
3957,107,31,2723.448437429072,4,4,3,11,1
3958,299,48,4499.466175185255,1,5,5,11,1
3959,245,36,3909.4299596978817,2,4,4,10,1
3960,336,48,228.4817641426758,1,5,1,7,2
3961,247,38,3468.2180478028627,2,4,4,10,1
3962,8,27,2525.2667985931243,5,3,3,11,1
3963,141,36,2383.008681591879,4,4,3,11,1
3964,362,48,3460.8762504594606,1,5,4,10,1
3965,8,23,989.1979106330301,5,3,1,9,2
3966,352,21,4907.628431671982,1,3,5,9,2
3967,94,13,3230.0795860595204,4,2,4,10,1
3968,321,37,1834.6243113131623,1,4,2,7,2
3969,39,47,3005.0090182701047,5,5,3,13,0
3970,81,26,1090.1896078152051,4,3,2,9,2
3971,187,40,3172.8709056262314,3,4,4,11,1
3972,84,7,150.8035322816088,4,1,1,6,3
3973,88,46,1712.4977379277473,4,5,2,11,1
3974,242,39,3740.109314770057,2,4,4,10,1
3975,342,22,4041.8094670795585,1,3,5,9,2
3976,93,39,1272.0678724367006,4,4,2,10,1
3977,86,23,2701.6532117871325,4,3,3,10,1
3978,44,30,2647.179519548699,5,3,3,11,1
3979,137,18,2113.0656714201345,4,2,3,9,2
3980,74,42,1149.8805839373629,4,5,2,11,1
3981,36,18,3519.1088838115766,5,2,4,11,1
3982,101,46,1269.284791910143,4,5,2,11,1
3983,156,10,4556.018428411512,3,1,5,9,2
3984,255,39,2647.221442681328,2,4,3,9,2
3985,171,30,4353.686903180003,3,3,5,11,1
3986,216,26,1460.8061768127782,3,3,2,8,2
3987,170,7,4037.324989731073,3,1,5,9,2
3988,252,7,577.1812886509626,2,1,1,4,3
3989,360,5,3836.4834066168933,1,1,4,6,3
3990,322,1,1940.8597911272582,1,1,2,4,3
3991,55,46,2355.2505432047483,5,5,3,13,0
3992,91,18,842.3685280952682,4,2,1,7,2
3993,278,13,102.95216573671777,2,2,1,5,3
3994,101,25,3334.325490710125,4,3,4,11,1
3995,155,40,2942.714234168087,3,4,3,10,1
3996,349,8,3115.9164788275903,1,1,4,6,3
3997,364,10,1282.45877255433,1,1,2,4,3
3998,141,32,1203.994539786699,4,4,2,10,1
3999,173,17,4153.178593233546,3,2,5,10,1
4000,10,38,3808.651235440233,5,4,4,13,0
4001,228,15,1690.5826780483897,2,2,2,6,3
4002,265,15,3192.650522718645,2,2,4,8,2
4003,248,48,4142.468520802381,2,5,5,12,1
4004,247,40,4445.258916667564,2,4,5,11,1
4005,155,20,38.97324193712074,3,2,1,6,3
4006,34,15,4069.177341742274,5,2,5,12,1
4007,129,35,1758.45774789216,4,4,2,10,1
4008,160,6,3594.707641033121,3,1,4,8,2
4009,89,30,1863.292809353998,4,3,2,9,2
4010,93,8,3035.1829431021342,4,1,4,9,2
4011,327,31,3237.444375630033,1,4,4,9,2
4012,241,48,2030.9139268719682,2,5,3,10,1
4013,323,47,2568.798802377347,1,5,3,9,2
4014,117,32,3634.30372587665,4,4,4,12,1
4015,94,45,2386.763290787362,4,5,3,12,1
4016,163,15,79.76262057498126,3,2,1,6,3
4017,99,18,74.3919430176037,4,2,1,7,2
4018,113,13,3309.941141746474,4,2,4,10,1
4019,359,24,4237.715311903435,1,3,5,9,2
4020,91,40,3928.514952194842,4,4,4,12,1
4021,346,14,1558.8975066464857,1,2,2,5,3
4022,206,28,2360.928146134803,3,3,3,9,2
4023,17,11,1178.4620931073182,5,2,2,9,2
4024,274,6,4945.858054226696,2,1,5,8,2
4025,173,25,1309.9271818085572,3,3,2,8,2
4026,116,1,2087.145348318339,4,1,3,8,2
4027,349,25,3408.833467108273,1,3,4,8,2
4028,181,2,4381.328171557372,3,1,5,9,2
4029,91,32,266.86366349501134,4,4,1,9,2
4030,82,13,1512.088183375336,4,2,2,8,2
4031,324,33,2849.2393813426575,1,4,3,8,2
4032,114,32,3095.3822760671555,4,4,4,12,1
4033,257,24,359.43691811430546,2,3,1,6,3
4034,58,27,3323.7529018319456,5,3,4,12,1
4035,154,4,2645.0411843867855,3,1,3,7,2
4036,116,24,4139.860623017102,4,3,5,12,1
4037,343,23,1118.7239892794205,1,3,2,6,3
4038,266,29,983.1846552591617,2,3,1,6,3
4039,315,34,3968.752737420499,1,4,4,9,2
4040,203,21,3522.3069534086853,3,3,4,10,1
4041,41,30,3960.450069282597,5,3,4,12,1
4042,105,26,3911.8513637301166,4,3,4,11,1
4043,193,20,528.9633723939988,3,2,1,6,3
4044,278,16,1400.1294060227626,2,2,2,6,3
4045,354,3,1307.8248293208674,1,1,2,4,3
4046,237,49,4673.59053427003,2,5,5,12,1
4047,221,37,2442.4582045112243,2,4,3,9,2
4048,68,40,564.1750921730867,5,4,1,10,1
4049,197,44,1454.9937505907935,3,5,2,10,1
4050,256,25,4360.789226097192,2,3,5,10,1
4051,139,23,4236.861227044913,4,3,5,12,1
4052,312,44,4502.694022368281,1,5,5,11,1
4053,149,1,1948.7585759577298,3,1,2,6,3
4054,99,33,3210.2913978350825,4,4,4,12,1
4055,76,15,1398.0878601778652,4,2,2,8,2
4056,282,17,912.3184024503456,2,2,1,5,3
4057,109,34,119.28636887257592,4,4,1,9,2
4058,188,17,1124.9703389498538,3,2,2,7,2
4059,199,41,3025.826943092442,3,5,3,11,1
4060,303,44,4522.009464897896,1,5,5,11,1
4061,327,4,675.7685605450545,1,1,1,3,3
4062,154,13,4590.877689217556,3,2,5,10,1
4063,40,4,1733.4723220098895,5,1,2,8,2
4064,133,7,2139.8737539954604,4,1,3,8,2
4065,132,46,1831.2429169390464,4,5,2,11,1
4066,279,9,2048.954618199323,2,1,3,6,3
4067,362,23,1303.3738144464494,1,3,2,6,3
4068,84,33,3496.0373447740785,4,4,4,12,1
4069,242,33,3793.333720248133,2,4,4,10,1
4070,116,20,4117.333325352802,4,2,5,11,1
4071,109,4,1713.0350209662356,4,1,2,7,2
4072,221,1,3825.488186228696,2,1,4,7,2
4073,41,42,3192.0000338093078,5,5,4,14,0
4074,147,34,4790.00127333356,3,4,5,12,1
4075,112,27,2129.6779818257523,4,3,3,10,1
4076,103,21,4961.625542137939,4,3,5,12,1
4077,46,24,3704.5662097392783,5,3,4,12,1
4078,324,15,3883.6259972453972,1,2,4,7,2
4079,271,35,138.2672519472084,2,4,1,7,2
4080,195,25,2492.017773167121,3,3,3,9,2
4081,280,9,2646.4001944370057,2,1,3,6,3
4082,283,17,212.594508583792,2,2,1,5,3
4083,40,21,1567.5348052178695,5,3,2,10,1
4084,189,13,4778.6644613327035,3,2,5,10,1
4085,164,3,2136.2960674370765,3,1,3,7,2
4086,24,4,941.6429029459541,5,1,1,7,2
4087,24,4,2571.5601480617765,5,1,3,9,2
4088,4,43,178.4902303301216,5,5,1,11,1
4089,323,28,2584.7836128545778,1,3,3,7,2
4090,290,7,2975.398847090138,2,1,3,6,3
4091,181,26,1794.8948691395012,3,3,2,8,2
4092,248,11,3815.2552284868625,2,2,4,8,2
4093,116,24,687.2132442350166,4,3,1,8,2
4094,279,43,4392.135215304676,2,5,5,12,1
4095,69,10,4777.670102848197,5,1,5,11,1
4096,351,37,16.16027776841377,1,4,1,6,3
4097,254,13,4215.1810836153645,2,2,5,9,2
4098,181,44,2535.464693047594,3,5,3,11,1
4099,318,42,2312.4141128541987,1,5,3,9,2
4100,169,39,1201.0087433031617,3,4,2,9,2
4101,313,19,2242.151955147067,1,2,3,6,3
4102,249,19,4752.631476654386,2,2,5,9,2
4103,188,12,1061.8302934323747,3,2,2,7,2
4104,54,22,903.4157798693042,5,3,1,9,2
4105,326,47,1217.0625572566453,1,5,2,8,2
4106,357,37,2763.6526297429596,1,4,3,8,2
4107,313,30,4652.196079012167,1,3,5,9,2
4108,138,46,2873.6691379186354,4,5,3,12,1
4109,168,12,1224.9775582630464,3,2,2,7,2
4110,103,29,2207.8570534530977,4,3,3,10,1
4111,85,21,1958.0966576108713,4,3,2,9,2
4112,317,11,242.38165461356195,1,2,1,4,3
4113,212,37,2558.1028241600025,3,4,3,10,1
4114,3,48,638.7718693020323,5,5,1,11,1
4115,179,18,4212.797769998537,3,2,5,10,1
4116,342,44,2749.3249173865247,1,5,3,9,2
4117,303,27,4224.586348260706,1,3,5,9,2
4118,332,37,4780.662990016425,1,4,5,10,1
4119,38,48,4716.509570843879,5,5,5,15,0
4120,239,12,511.14237819469315,2,2,1,5,3
4121,169,23,4724.637187034536,3,3,5,11,1
4122,343,34,3980.7785668696556,1,4,4,9,2
4123,314,38,3890.513945251347,1,4,4,9,2
4124,306,23,459.74141593819525,1,3,1,5,3
4125,30,25,905.7783643951595,5,3,1,9,2
4126,190,4,4876.065265774694,3,1,5,9,2
4127,357,30,1074.717084204919,1,3,2,6,3
4128,25,30,853.5761175353292,5,3,1,9,2
4129,112,13,1818.1345773602445,4,2,2,8,2
4130,206,42,4567.647425699102,3,5,5,13,0
4131,185,49,2386.205383147212,3,5,3,11,1
4132,47,14,4603.712758254542,5,2,5,12,1
4133,228,47,1678.350514272026,2,5,2,9,2
4134,39,8,1140.3779396827267,5,1,2,8,2
4135,16,24,2481.063014166667,5,3,3,11,1
4136,22,18,3081.229682406824,5,2,4,11,1
4137,213,35,1963.580003081645,3,4,2,9,2
4138,310,25,1736.6922428767134,1,3,2,6,3
4139,149,17,1098.1158310185008,3,2,2,7,2
4140,241,32,1382.2837634466396,2,4,2,8,2
4141,272,24,3368.858636129981,2,3,4,9,2
4142,59,7,1855.6689576822528,5,1,2,8,2
4143,287,13,407.98763818793213,2,2,1,5,3
4144,202,27,699.3953958631478,3,3,1,7,2
4145,32,48,1868.1721500716426,5,5,2,12,1
4146,162,5,4623.267124940831,3,1,5,9,2
4147,255,36,1901.3610056134416,2,4,2,8,2
4148,254,26,312.6039664838596,2,3,1,6,3
4149,9,42,2095.791346821279,5,5,3,13,0
4150,139,45,3347.3997938612274,4,5,4,13,0
4151,10,31,2972.0447133916227,5,4,3,12,1
4152,214,10,1401.22678230629,3,1,2,6,3
4153,273,46,3443.5637260129834,2,5,4,11,1
4154,324,26,3156.815625588009,1,3,4,8,2
4155,48,22,869.1431144565533,5,3,1,9,2
4156,111,12,819.1035678055426,4,2,1,7,2
4157,153,32,2740.4435795190243,3,4,3,10,1
4158,123,27,3300.598419969358,4,3,4,11,1
4159,357,33,4809.9338184527005,1,4,5,10,1
4160,102,20,2115.433847351581,4,2,3,9,2
4161,241,39,3827.0468059628474,2,4,4,10,1
4162,321,41,591.4385289839682,1,5,1,7,2
4163,191,40,4449.1490463050795,3,4,5,12,1
4164,217,13,3169.206631580211,3,2,4,9,2
4165,51,14,3148.861353442724,5,2,4,11,1
4166,292,44,720.7887428238531,1,5,1,7,2
4167,81,40,207.52281033423077,4,4,1,9,2
4168,88,22,3510.231198543252,4,3,4,11,1
4169,194,18,594.1117302332872,3,2,1,6,3
4170,104,48,643.5810459248241,4,5,1,10,1
4171,271,29,945.625730271455,2,3,1,6,3
4172,96,43,497.7549508666161,4,5,1,10,1
4173,198,16,3130.7086769472307,3,2,4,9,2
4174,1,46,2115.803981184454,5,5,3,13,0
4175,167,35,1337.8195011236458,3,4,2,9,2
4176,126,34,2209.339507854167,4,4,3,11,1
4177,313,3,4222.258610305347,1,1,5,7,2
4178,81,4,4636.126231167745,4,1,5,10,1
4179,251,5,2442.5059618206733,2,1,3,6,3
4180,169,10,2838.097046412884,3,1,3,7,2
4181,73,29,1293.4276523959657,5,3,2,10,1
4182,141,32,2572.865889399225,4,4,3,11,1
4183,70,31,3743.1168386068084,5,4,4,13,0
4184,262,2,2465.764945644286,2,1,3,6,3
4185,340,12,1517.3437749379568,1,2,2,5,3
4186,308,27,2914.3513926525457,1,3,3,7,2
4187,245,5,4733.8135941203645,2,1,5,8,2
4188,3,37,4441.039431375728,5,4,5,14,0
4189,337,27,3848.5194720855266,1,3,4,8,2
4190,63,23,1388.2860669993931,5,3,2,10,1
4191,49,33,1215.381941009843,5,4,2,11,1
4192,76,4,4194.300577090014,4,1,5,10,1
4193,175,21,914.7742056496908,3,3,1,7,2
4194,109,24,3032.0004243583517,4,3,3,10,1
4195,183,44,2200.2604184789916,3,5,3,11,1
4196,192,31,2345.2524717890674,3,4,3,10,1
4197,65,44,2278.1715786124287,5,5,3,13,0
4198,337,48,4500.751232151064,1,5,5,11,1
4199,271,24,444.6003119683203,2,3,1,6,3
4200,100,49,3916.6782327859323,4,5,4,13,0
4201,32,10,4176.713231160664,5,1,5,11,1
4202,352,49,4714.956964295916,1,5,5,11,1
4203,128,49,2268.4737751391795,4,5,3,12,1
4204,339,2,2505.325307515714,1,1,3,5,3
4205,43,31,4806.859660493174,5,4,5,14,0
4206,78,25,2297.6707941363234,4,3,3,10,1
4207,314,4,2522.7068801515265,1,1,3,5,3
4208,289,11,1667.949047765026,2,2,2,6,3
4209,270,17,167.82097891640296,2,2,1,5,3
4210,162,44,2170.9422132898485,3,5,3,11,1
4211,189,2,3278.905641128456,3,1,4,8,2
4212,247,6,3452.83009396165,2,1,4,7,2
4213,216,9,42.478147954201425,3,1,1,5,3
4214,315,5,4007.253346116415,1,1,4,6,3
4215,339,20,2467.1539145014494,1,2,3,6,3
4216,168,29,2608.5193533171023,3,3,3,9,2
4217,339,21,4809.101003970133,1,3,5,9,2
4218,193,9,1429.4611816925312,3,1,2,6,3
4219,283,28,3810.643424951155,2,3,4,9,2
4220,336,8,2878.1334659046315,1,1,3,5,3
4221,13,31,3506.9843231746113,5,4,4,13,0
4222,240,20,2094.9090843878103,2,2,3,7,2
4223,320,27,1403.2456194316994,1,3,2,6,3
4224,147,8,2735.168502320983,3,1,3,7,2
4225,204,21,1880.9563202997083,3,3,2,8,2
4226,80,28,1122.3267823600231,4,3,2,9,2
4227,43,23,4197.788379087675,5,3,5,13,0
4228,89,6,2384.3996590564434,4,1,3,8,2
4229,148,3,4238.105548542588,3,1,5,9,2
4230,95,5,2375.4175960209122,4,1,3,8,2
4231,151,9,2788.4205115849163,3,1,3,7,2
4232,2,7,4976.448404156635,5,1,5,11,1
4233,22,4,4758.006018055447,5,1,5,11,1
4234,313,39,1365.7324546277844,1,4,2,7,2
4235,328,5,4344.5903783816175,1,1,5,7,2
4236,7,11,1958.1133836489944,5,2,2,9,2
4237,206,15,365.53120217285993,3,2,1,6,3
4238,114,34,2883.1472639787476,4,4,3,11,1
4239,272,13,4885.488778676634,2,2,5,9,2
4240,83,48,4871.825298156373,4,5,5,14,0
4241,179,7,641.0622370307156,3,1,1,5,3
4242,210,40,3858.470966423071,3,4,4,11,1
4243,328,6,4016.136890808535,1,1,5,7,2
4244,124,39,1850.0364737401335,4,4,2,10,1
4245,113,30,3296.389954130472,4,3,4,11,1
4246,12,22,2445.9157966033363,5,3,3,11,1
4247,126,25,1147.1865575725344,4,3,2,9,2
4248,53,28,3808.708763312688,5,3,4,12,1
4249,331,20,1321.1360119839414,1,2,2,5,3
4250,283,39,1708.8342876778793,2,4,2,8,2
4251,140,3,958.1918405281507,4,1,1,6,3
4252,97,5,3599.1638059056345,4,1,4,9,2
4253,5,1,2299.033028614591,5,1,3,9,2
4254,57,15,2222.4325416462766,5,2,3,10,1
4255,334,26,3026.7687057811627,1,3,3,7,2
4256,69,3,794.7446017642133,5,1,1,7,2
4257,118,40,4491.787909232539,4,4,5,13,0
4258,59,41,2330.8936916172956,5,5,3,13,0
4259,33,47,1838.969024823329,5,5,2,12,1
4260,318,42,642.1861384369104,1,5,1,7,2
4261,50,34,848.0914797933972,5,4,1,10,1
4262,19,5,4602.597966430162,5,1,5,11,1
4263,214,31,2288.518996664614,3,4,3,10,1
4264,197,13,3613.697757602711,3,2,4,9,2
4265,47,43,411.7765997660806,5,5,1,11,1
4266,167,1,3220.8880751911543,3,1,4,8,2
4267,289,22,4608.380769763732,2,3,5,10,1
4268,141,15,1506.8176198986407,4,2,2,8,2
4269,84,26,2899.911098560062,4,3,3,10,1
4270,182,18,4701.693330536094,3,2,5,10,1
4271,79,48,3599.4195434855537,4,5,4,13,0
4272,215,9,321.0042568965457,3,1,1,5,3
4273,14,1,1899.8983648295898,5,1,2,8,2
4274,215,43,438.00605287556914,3,5,1,9,2
4275,128,9,4307.9748050338785,4,1,5,10,1
4276,310,23,3112.096879006041,1,3,4,8,2
4277,248,43,4782.3449067210895,2,5,5,12,1
4278,29,45,108.58408263717774,5,5,1,11,1
4279,280,2,2121.2059755709824,2,1,3,6,3
4280,338,14,530.7768567265298,1,2,1,4,3
4281,319,38,1758.9342348733646,1,4,2,7,2
4282,202,40,817.8152485493691,3,4,1,8,2
4283,361,18,1650.6808623671668,1,2,2,5,3
4284,57,16,4098.117403562925,5,2,5,12,1
4285,218,29,811.8896391486909,2,3,1,6,3
4286,62,44,2373.5871371914195,5,5,3,13,0
4287,157,11,4608.699838962027,3,2,5,10,1
4288,202,6,4993.908646392989,3,1,5,9,2
4289,17,3,1260.6991796936657,5,1,2,8,2
4290,322,14,4678.48517212284,1,2,5,8,2
4291,6,2,1314.3295171971172,5,1,2,8,2
4292,58,32,2073.5072099281306,5,4,3,12,1
4293,325,31,4390.838825044304,1,4,5,10,1
4294,318,11,3933.0187635719985,1,2,4,7,2
4295,169,22,4288.862910546439,3,3,5,11,1
4296,82,3,4003.2808297292086,4,1,4,9,2
4297,219,31,1182.9544150001063,2,4,2,8,2
4298,177,33,2798.3876259987046,3,4,3,10,1
4299,204,24,1932.4010846259905,3,3,2,8,2
4300,71,1,2303.9577325573596,5,1,3,9,2
4301,266,44,778.2419475969175,2,5,1,8,2
4302,98,15,1585.680120533601,4,2,2,8,2
4303,345,37,4289.6591358967125,1,4,5,10,1
4304,291,27,4488.816465331958,2,3,5,10,1
4305,208,38,3054.6638886567016,3,4,4,11,1
4306,2,48,2496.3536124337566,5,5,3,13,0
4307,124,27,3567.0700438650088,4,3,4,11,1
4308,280,44,3048.1777186087893,2,5,4,11,1
4309,74,12,4918.53828167559,4,2,5,11,1
4310,166,3,958.5430728993744,3,1,1,5,3
4311,22,30,2250.733183969943,5,3,3,11,1
4312,154,32,4592.020106404912,3,4,5,12,1
4313,295,23,4574.537928943536,1,3,5,9,2
4314,219,2,2481.780764340256,2,1,3,6,3
4315,157,7,682.6969199868935,3,1,1,5,3
4316,230,34,4076.6402577895833,2,4,5,11,1
4317,20,32,2929.9742806517042,5,4,3,12,1
4318,41,39,3868.098419127711,5,4,4,13,0
4319,148,32,2317.9929207388454,3,4,3,10,1
4320,108,43,1027.3807704647647,4,5,2,11,1
4321,84,43,129.70714332280895,4,5,1,10,1
4322,322,14,2800.0999615103633,1,2,3,6,3
4323,309,3,813.620432619132,1,1,1,3,3
4324,290,46,943.8146709031291,2,5,1,8,2
4325,323,32,2187.16509847625,1,4,3,8,2
4326,134,43,2215.9645964601,4,5,3,12,1
4327,207,36,1379.1915801264695,3,4,2,9,2
4328,283,17,668.2918200331077,2,2,1,5,3
4329,266,48,4725.314231593465,2,5,5,12,1
4330,73,3,666.8866732325171,5,1,1,7,2
4331,352,10,1760.3551971596362,1,1,2,4,3
4332,48,47,1531.2912831111566,5,5,2,12,1
4333,326,40,4333.026105823174,1,4,5,10,1
4334,233,18,2056.2116179080667,2,2,3,7,2
4335,100,3,628.9770611794779,4,1,1,6,3
4336,59,39,61.20253173843198,5,4,1,10,1
4337,258,10,3612.528521337879,2,1,4,7,2
4338,65,9,3575.3604519135724,5,1,4,10,1
4339,83,46,2094.7405198530064,4,5,3,12,1
4340,154,46,640.2769215584947,3,5,1,9,2
4341,266,11,1864.4527247380117,2,2,2,6,3
4342,309,33,2953.5134300759837,1,4,3,8,2
4343,79,36,3522.675279616137,4,4,4,12,1
4344,315,26,400.41706324703824,1,3,1,5,3
4345,150,27,2785.974278367248,3,3,3,9,2
4346,48,38,1387.8591514562065,5,4,2,11,1
4347,248,22,3090.1587727968767,2,3,4,9,2
4348,278,26,3244.2192130951566,2,3,4,9,2
4349,356,22,4553.912471855845,1,3,5,9,2
4350,98,5,2057.7880931909103,4,1,3,8,2
4351,25,35,2692.5773940752347,5,4,3,12,1
4352,284,2,1348.3934625749414,2,1,2,5,3
4353,301,35,1439.9195504841857,1,4,2,7,2
4354,68,9,239.7085699911989,5,1,1,7,2
4355,7,49,1437.4840220695467,5,5,2,12,1
4356,305,18,328.50516105738296,1,2,1,4,3
4357,137,43,4819.93979502329,4,5,5,14,0
4358,164,12,3125.0735445267615,3,2,4,9,2
4359,83,3,874.0113203196074,4,1,1,6,3
4360,138,18,592.6641355034723,4,2,1,7,2
4361,73,38,1856.9118761829416,5,4,2,11,1
4362,237,7,1545.1601498480184,2,1,2,5,3
4363,46,33,1403.4813567631204,5,4,2,11,1
4364,106,6,2346.2982642057955,4,1,3,8,2
4365,288,18,4565.240476452553,2,2,5,9,2
4366,262,45,2844.570769471118,2,5,3,10,1
4367,176,22,2610.9452078872296,3,3,3,9,2
4368,166,39,4034.6766914536793,3,4,5,12,1
4369,145,9,30.08281186847691,4,1,1,6,3
4370,330,35,994.954489084615,1,4,1,6,3
4371,283,23,2485.967812600292,2,3,3,8,2
4372,54,12,3529.492212005113,5,2,4,11,1
4373,178,24,2430.290692748795,3,3,3,9,2
4374,244,40,826.942746691377,2,4,1,7,2
4375,341,9,4650.614260131267,1,1,5,7,2
4376,127,13,1650.0390042161719,4,2,2,8,2
4377,271,40,3943.1962501585754,2,4,4,10,1
4378,132,42,4458.1525396420875,4,5,5,14,0
4379,93,17,1738.7823946664457,4,2,2,8,2
4380,73,7,4228.1057888372225,5,1,5,11,1
4381,248,17,3556.760679002319,2,2,4,8,2
4382,348,24,4522.361374943411,1,3,5,9,2
4383,273,2,1264.0404015976585,2,1,2,5,3
4384,43,35,4657.0752546299955,5,4,5,14,0
4385,41,28,335.8793185829521,5,3,1,9,2
4386,170,19,3970.419713675188,3,2,4,9,2
4387,212,33,2183.9684533011473,3,4,3,10,1
4388,168,21,897.6709345962737,3,3,1,7,2
4389,39,10,406.2207459623711,5,1,1,7,2
4390,245,46,1953.842094355701,2,5,2,9,2
4391,151,45,1952.7263694153396,3,5,2,10,1
4392,111,9,1157.4873476918572,4,1,2,7,2
4393,47,38,1085.4218377806858,5,4,2,11,1
4394,63,6,2003.576347253612,5,1,2,8,2
4395,225,42,2056.468277193735,2,5,3,10,1
4396,69,35,2217.4003478243294,5,4,3,12,1
4397,299,18,4345.109339771562,1,2,5,8,2
4398,290,19,3060.1599870495597,2,2,4,8,2
4399,296,5,111.9614986969098,1,1,1,3,3
4400,203,25,2600.3052163932966,3,3,3,9,2
4401,61,11,3814.631966968915,5,2,4,11,1
4402,318,10,291.5073901561408,1,1,1,3,3
4403,314,17,2118.813317577792,1,2,3,6,3
4404,161,36,2261.5386148552593,3,4,3,10,1
4405,331,26,4770.562057155521,1,3,5,9,2
4406,16,31,2383.662929376972,5,4,3,12,1
4407,338,32,3752.002310684389,1,4,4,9,2
4408,94,21,1521.4812055931736,4,3,2,9,2
4409,304,18,3898.740189430273,1,2,4,7,2
4410,138,18,1620.0852088217296,4,2,2,8,2
4411,338,1,2155.8177008515986,1,1,3,5,3
4412,38,14,2402.6165662803724,5,2,3,10,1
4413,127,8,4632.551217395877,4,1,5,10,1
4414,275,2,276.7332035462891,2,1,1,4,3
4415,164,15,992.367083543928,3,2,1,6,3
4416,319,34,3531.6563035255444,1,4,4,9,2
4417,77,36,2892.112522811024,4,4,3,11,1
4418,174,1,1265.1416381707295,3,1,2,6,3
4419,358,21,1453.112428580114,1,3,2,6,3
4420,321,42,1842.874333187313,1,5,2,8,2
4421,91,1,2257.2312771583393,4,1,3,8,2
4422,238,32,4091.9563430313624,2,4,5,11,1
4423,264,20,78.93922759509324,2,2,1,5,3
4424,179,47,4491.118508655257,3,5,5,13,0
4425,209,36,2071.0052870413256,3,4,3,10,1
4426,73,39,1160.1826126564015,5,4,2,11,1
4427,107,30,2546.979370641453,4,3,3,10,1
4428,345,7,3301.7535130708957,1,1,4,6,3
4429,295,22,233.31357377608148,1,3,1,5,3
4430,284,45,3581.728984813752,2,5,4,11,1
4431,353,10,3806.1983260434736,1,1,4,6,3
4432,182,8,839.2495987738623,3,1,1,5,3
4433,37,27,847.7283276007455,5,3,1,9,2
4434,137,10,1026.8849271589756,4,1,2,7,2
4435,338,14,3985.177273215846,1,2,4,7,2
4436,56,46,1367.2952490966336,5,5,2,12,1
4437,187,11,3981.719831891229,3,2,4,9,2
4438,341,6,2707.214056104857,1,1,3,5,3
4439,258,21,3838.1849375573256,2,3,4,9,2
4440,58,33,2772.828477981258,5,4,3,12,1
4441,363,19,1685.4868070668358,1,2,2,5,3
4442,123,39,4554.46357186371,4,4,5,13,0
4443,188,24,3579.3253526687463,3,3,4,10,1
4444,230,18,2425.4334645532012,2,2,3,7,2
4445,168,35,3190.7680971125947,3,4,4,11,1
4446,114,43,3083.058345786275,4,5,4,13,0
4447,252,37,1796.9999203563075,2,4,2,8,2
4448,107,19,2124.6210164298136,4,2,3,9,2
4449,37,24,1598.1013203892721,5,3,2,10,1
4450,335,34,4997.595475763111,1,4,5,10,1
4451,92,22,2904.5216253821027,4,3,3,10,1
4452,18,4,469.3560522763368,5,1,1,7,2
4453,354,10,2600.3448466711616,1,1,3,5,3
4454,63,2,259.31020371248104,5,1,1,7,2
4455,150,8,1450.3737210816996,3,1,2,6,3
4456,139,33,2235.345968721154,4,4,3,11,1
4457,186,38,2676.0097281435405,3,4,3,10,1
4458,185,43,4881.145184643991,3,5,5,13,0
4459,205,28,4911.286401782719,3,3,5,11,1
4460,260,10,499.36615583270844,2,1,1,4,3
4461,214,45,2695.282037086817,3,5,3,11,1
4462,256,1,4087.375882008649,2,1,5,8,2
4463,135,34,1196.1869730612461,4,4,2,10,1
4464,61,3,3755.309861956473,5,1,4,10,1
4465,363,9,4394.309087967847,1,1,5,7,2
4466,310,5,3315.8121062169384,1,1,4,6,3
4467,88,42,1645.2397107371432,4,5,2,11,1
4468,324,10,4616.430273509457,1,1,5,7,2
4469,207,12,4418.7652674341025,3,2,5,10,1
4470,129,18,3581.968340782247,4,2,4,10,1
4471,311,21,1824.7038860514938,1,3,2,6,3
4472,3,21,3961.5628483500486,5,3,4,12,1
4473,242,1,1587.3838176956845,2,1,2,5,3
4474,121,3,1272.2347281545178,4,1,2,7,2
4475,102,5,2579.9168006872924,4,1,3,8,2
4476,38,25,4985.704772756241,5,3,5,13,0
4477,341,49,4023.566487756264,1,5,5,11,1
4478,133,8,3651.6657332704353,4,1,4,9,2
4479,202,17,2265.5436060029465,3,2,3,8,2
4480,348,9,1566.6305458372221,1,1,2,4,3
4481,21,32,4280.944808121074,5,4,5,14,0
4482,242,6,2842.986572105286,2,1,3,6,3
4483,109,49,4068.142206098276,4,5,5,14,0
4484,303,40,2443.8910107591832,1,4,3,8,2
4485,84,21,3772.2478951203807,4,3,4,11,1
4486,83,7,4340.0278827717575,4,1,5,10,1
4487,291,7,1963.0362320852978,2,1,2,5,3
4488,69,47,77.71215382103945,5,5,1,11,1
4489,129,39,1282.083564444336,4,4,2,10,1
4490,196,27,4575.4260550112,3,3,5,11,1
4491,140,8,3440.835880155932,4,1,4,9,2
4492,283,9,3688.7213950203322,2,1,4,7,2
4493,312,28,1633.190185184453,1,3,2,6,3
4494,234,15,3509.3521935282256,2,2,4,8,2
4495,23,2,3234.947905593032,5,1,4,10,1
4496,153,7,900.0845807503747,3,1,1,5,3
4497,277,47,4843.766979378916,2,5,5,12,1
4498,61,18,1776.5877108052225,5,2,2,9,2
4499,319,22,1653.1419994618109,1,3,2,6,3
4500,52,10,1852.1161057086879,5,1,2,8,2
4501,344,33,467.680880450639,1,4,1,6,3
4502,153,7,3128.567950295147,3,1,4,8,2
4503,237,3,1200.73497629452,2,1,2,5,3
4504,311,14,4018.5306543570628,1,2,5,8,2
4505,302,44,1976.8393388683896,1,5,2,8,2
4506,32,46,2298.2068266303536,5,5,3,13,0
4507,55,36,3235.6460500366393,5,4,4,13,0
4508,352,13,3811.7369584291587,1,2,4,7,2
4509,36,16,1163.2653711920775,5,2,2,9,2
4510,110,16,4831.808705293549,4,2,5,11,1
4511,177,5,3115.3845143737394,3,1,4,8,2
4512,362,25,38.13673126693399,1,3,1,5,3
4513,314,38,2083.9548275185202,1,4,3,8,2
4514,295,38,2189.7209249474636,1,4,3,8,2
4515,336,38,4047.733230112241,1,4,5,10,1
4516,97,39,1532.6474728613143,4,4,2,10,1
4517,213,48,1662.8203163118676,3,5,2,10,1
4518,317,41,361.7655233343139,1,5,1,7,2
4519,137,26,1424.8946623838158,4,3,2,9,2
4520,6,13,3587.638890414392,5,2,4,11,1
4521,109,44,3177.4370286035,4,5,4,13,0
4522,35,26,416.15649915939133,5,3,1,9,2
4523,39,1,582.322521652767,5,1,1,7,2
4524,150,8,1890.860559986289,3,1,2,6,3
4525,118,4,3721.351233083639,4,1,4,9,2
4526,261,21,4166.262207861863,2,3,5,10,1
4527,87,22,82.97397461998686,4,3,1,8,2
4528,76,37,1651.7627807639294,4,4,2,10,1
4529,313,49,2127.066699506589,1,5,3,9,2
4530,214,3,4556.552725844378,3,1,5,9,2
4531,285,19,2512.01872297012,2,2,3,7,2
4532,239,1,1355.8068185759619,2,1,2,5,3
4533,165,29,1956.3348551675856,3,3,2,8,2
4534,87,23,2187.8078630587884,4,3,3,10,1
4535,141,33,3353.2794089110994,4,4,4,12,1
4536,160,41,215.02803700745181,3,5,1,9,2
4537,46,23,1953.363798491508,5,3,2,10,1
4538,112,5,3236.307638203112,4,1,4,9,2
4539,45,7,1423.7783536683432,5,1,2,8,2
4540,247,6,2962.8375232541293,2,1,3,6,3
4541,104,49,1792.8218612191802,4,5,2,11,1
4542,85,22,3796.0171288588094,4,3,4,11,1
4543,134,49,312.3825053478424,4,5,1,10,1
4544,108,13,4590.630283699768,4,2,5,11,1
4545,18,12,866.3466142653883,5,2,1,8,2
4546,94,4,801.1499628792523,4,1,1,6,3
4547,150,8,4204.808294418331,3,1,5,9,2
4548,246,37,4347.7217858892045,2,4,5,11,1
4549,289,31,473.9368340945434,2,4,1,7,2
4550,209,37,4544.507450794402,3,4,5,12,1
4551,126,45,1373.7563549775916,4,5,2,11,1
4552,235,26,3096.922210186197,2,3,4,9,2
4553,122,43,352.2815171353998,4,5,1,10,1
4554,138,8,1909.4988946297228,4,1,2,7,2
4555,115,40,2259.1157994316436,4,4,3,11,1
4556,162,33,3003.1345810879893,3,4,3,10,1
4557,201,45,2631.107137358184,3,5,3,11,1
4558,234,29,2312.849877843047,2,3,3,8,2
4559,28,5,4798.604656710284,5,1,5,11,1
4560,11,28,933.2636571689181,5,3,1,9,2
4561,206,40,798.3912109268742,3,4,1,8,2
4562,167,17,3569.9611138943515,3,2,4,9,2
4563,247,23,382.0139055024583,2,3,1,6,3
4564,47,45,2419.628365411441,5,5,3,13,0
4565,246,9,2425.425064569514,2,1,3,6,3
4566,127,2,1557.0264014858658,4,1,2,7,2
4567,147,32,4652.914270984186,3,4,5,12,1
4568,118,49,1419.891741129097,4,5,2,11,1
4569,152,31,1449.3253416688501,3,4,2,9,2
4570,72,7,1179.1568214763683,5,1,2,8,2
4571,363,30,737.4822957506096,1,3,1,5,3
4572,137,3,1826.4151661887795,4,1,2,7,2
4573,175,9,3407.627427402146,3,1,4,8,2
4574,289,10,3713.3926852260715,2,1,4,7,2
4575,19,46,4068.960392989098,5,5,5,15,0
4576,195,47,995.7440037724773,3,5,1,9,2
4577,330,26,187.8071143162515,1,3,1,5,3
4578,175,1,4873.682433857075,3,1,5,9,2
4579,354,30,81.5192712392784,1,3,1,5,3
4580,141,38,4803.787401410712,4,4,5,13,0
4581,246,15,4145.783949371881,2,2,5,9,2
4582,93,25,4561.2530575154315,4,3,5,12,1
4583,239,6,1942.0567059296184,2,1,2,5,3
4584,205,18,994.0379742666561,3,2,1,6,3
4585,48,1,3036.253789026069,5,1,4,10,1
4586,245,3,3708.8433418752693,2,1,4,7,2
4587,320,17,662.9967209600561,1,2,1,4,3
4588,317,48,3990.131358275825,1,5,4,10,1
4589,295,8,1050.8806668626642,1,1,2,4,3
4590,128,49,2463.469691613215,4,5,3,12,1
4591,344,40,4283.847424891983,1,4,5,10,1
4592,282,17,975.1883101030357,2,2,1,5,3
4593,17,25,1217.0043934341097,5,3,2,10,1
4594,71,41,323.22807093096566,5,5,1,11,1
4595,269,12,741.6044177978209,2,2,1,5,3
4596,325,29,741.1638407090297,1,3,1,5,3
4597,282,25,1025.1032357491463,2,3,2,7,2
4598,305,36,1438.1399813542696,1,4,2,7,2
4599,7,25,4076.7669887479187,5,3,5,13,0
4600,314,29,4579.661682263776,1,3,5,9,2
4601,305,11,2037.340240052462,1,2,3,6,3
4602,103,4,649.762670421671,4,1,1,6,3
4603,309,14,1126.8115262266979,1,2,2,5,3
4604,193,46,3683.667824507575,3,5,4,12,1
4605,241,38,3390.3533408723197,2,4,4,10,1
4606,62,17,4836.364435012395,5,2,5,12,1
4607,17,2,82.29851616946534,5,1,1,7,2
4608,171,8,3756.286213808961,3,1,4,8,2
4609,25,36,2533.9100662603782,5,4,3,12,1
4610,251,10,4514.437959833072,2,1,5,8,2
4611,253,7,2885.071703893066,2,1,3,6,3
4612,207,36,2238.871945062463,3,4,3,10,1
4613,29,16,3332.594541370044,5,2,4,11,1
4614,117,14,4169.281976483178,4,2,5,11,1
4615,282,16,1419.6677653625313,2,2,2,6,3
4616,144,25,546.5599484834471,4,3,1,8,2
4617,25,41,2170.7604104134093,5,5,3,13,0
4618,310,4,1080.4541653305255,1,1,2,4,3
4619,156,29,2153.4104652220935,3,3,3,9,2
4620,73,6,4955.330382266761,5,1,5,11,1
4621,120,1,2874.8692479323695,4,1,3,8,2
4622,312,39,3471.065112005251,1,4,4,9,2
4623,321,1,3392.8628280824782,1,1,4,6,3
4624,93,40,4105.297173067456,4,4,5,13,0
4625,86,3,4721.201709086744,4,1,5,10,1
4626,336,1,3297.502310058187,1,1,4,6,3
4627,364,1,2385.7122773185088,1,1,3,5,3
4628,118,39,1595.976422625378,4,4,2,10,1
4629,233,21,1807.7687576180967,2,3,2,7,2
4630,199,45,1679.0582345390428,3,5,2,10,1
4631,206,30,1629.0828014567107,3,3,2,8,2
4632,339,32,3476.1787718666505,1,4,4,9,2
4633,147,33,2942.668059459802,3,4,3,10,1
4634,271,48,1017.955274139454,2,5,1,8,2
4635,139,22,4848.433835639317,4,3,5,12,1
4636,181,30,2144.350321618053,3,3,3,9,2
4637,30,46,2834.771141329711,5,5,3,13,0
4638,57,4,3515.978824280916,5,1,4,10,1
4639,232,23,3072.2501096177084,2,3,4,9,2
4640,146,44,1562.1483277870482,4,5,2,11,1
4641,48,25,3990.55580170201,5,3,4,12,1
4642,194,12,559.6666615023381,3,2,1,6,3
4643,224,17,2849.2892151713204,2,2,3,7,2
4644,136,15,1373.8529428403624,4,2,2,8,2
4645,22,10,3082.654214688361,5,1,4,10,1
4646,6,35,1097.7874706110051,5,4,2,11,1
4647,204,29,3863.2762794945975,3,3,4,10,1
4648,239,12,1145.4062930165048,2,2,2,6,3
4649,185,1,4453.056753484494,3,1,5,9,2
4650,360,1,4309.158974304453,1,1,5,7,2
4651,292,10,1818.343325548918,1,1,2,4,3
4652,335,18,1935.243241481389,1,2,2,5,3
4653,220,47,3510.502253860577,2,5,4,11,1
4654,116,2,460.9639544826948,4,1,1,6,3
4655,313,49,413.78786675663986,1,5,1,7,2
4656,49,8,690.2577422013763,5,1,1,7,2
4657,173,22,2816.751923894763,3,3,3,9,2
4658,82,22,753.5215011071551,4,3,1,8,2
4659,322,26,1395.310236047177,1,3,2,6,3
4660,333,26,3238.0879236256374,1,3,4,8,2
4661,45,9,87.96265140521052,5,1,1,7,2
4662,335,21,909.3806736878146,1,3,1,5,3
4663,20,31,4650.354007749762,5,4,5,14,0
4664,221,43,3321.252340809478,2,5,4,11,1
4665,123,6,1534.700059973835,4,1,2,7,2
4666,234,14,236.06408606523135,2,2,1,5,3
4667,221,33,2934.3835539780107,2,4,3,9,2
4668,323,7,1122.1028863632787,1,1,2,4,3
4669,339,24,4801.275439204483,1,3,5,9,2
4670,3,9,3437.9351653843546,5,1,4,10,1
4671,182,11,4870.878192867069,3,2,5,10,1
4672,206,23,4246.0054980837185,3,3,5,11,1
4673,320,48,2420.3068018007975,1,5,3,9,2
4674,40,2,3351.1201067941765,5,1,4,10,1
4675,59,15,4062.4149057411078,5,2,5,12,1
4676,62,35,2895.1106234964896,5,4,3,12,1
4677,132,36,316.8226298314138,4,4,1,9,2
4678,60,28,2357.527106229419,5,3,3,11,1
4679,331,39,661.5609206253331,1,4,1,6,3
4680,122,44,3577.0854082987507,4,5,4,13,0
4681,107,4,3406.3382890316343,4,1,4,9,2
4682,96,10,4964.611878340046,4,1,5,10,1
4683,347,6,3147.7609109525974,1,1,4,6,3
4684,235,30,4002.688332495869,2,3,4,9,2
4685,62,46,1348.7563759352745,5,5,2,12,1
4686,256,35,1706.720435126939,2,4,2,8,2
4687,49,49,4585.951019365408,5,5,5,15,0
4688,348,43,3778.4093755324675,1,5,4,10,1
4689,159,10,3279.793182240212,3,1,4,8,2
4690,124,32,1277.598185989371,4,4,2,10,1
4691,317,42,3495.903864338574,1,5,4,10,1
4692,207,42,4434.950588759337,3,5,5,13,0
4693,48,3,1161.6802979243355,5,1,2,8,2
4694,136,26,3533.558500099958,4,3,4,11,1
4695,201,15,1974.5328274535684,3,2,2,7,2
4696,250,17,602.6493905736937,2,2,1,5,3
4697,314,27,3819.6687759030733,1,3,4,8,2
4698,357,18,844.0125780298386,1,2,1,4,3
4699,318,19,1271.9524047169532,1,2,2,5,3
4700,295,12,3916.880783984674,1,2,4,7,2
4701,314,24,3713.2426002669417,1,3,4,8,2
4702,209,5,1278.3734995615312,3,1,2,6,3
4703,355,24,4705.413425588373,1,3,5,9,2
4704,211,27,1084.2732731351855,3,3,2,8,2
4705,192,48,4968.174852670521,3,5,5,13,0
4706,44,30,3692.120361037683,5,3,4,12,1
4707,29,15,1968.6133758514993,5,2,2,9,2
4708,59,47,660.4425412457949,5,5,1,11,1
4709,71,38,1609.3446762464723,5,4,2,11,1
4710,92,44,976.7551722105932,4,5,1,10,1
4711,265,34,3112.979536605156,2,4,4,10,1
4712,220,27,1790.7072141584038,2,3,2,7,2
4713,215,20,1482.0862336068465,3,2,2,7,2
4714,277,41,3788.094626674677,2,5,4,11,1
4715,64,32,1160.6911799024135,5,4,2,11,1
4716,346,4,2938.5776939532684,1,1,3,5,3
4717,292,5,981.0345031894926,1,1,1,3,3
4718,245,8,3576.8450525881467,2,1,4,7,2
4719,62,22,3129.3562039254575,5,3,4,12,1
4720,332,42,3992.7860407333847,1,5,4,10,1
4721,170,7,351.800403065768,3,1,1,5,3
4722,269,22,1058.4261930300574,2,3,2,7,2
4723,267,46,780.7571991617938,2,5,1,8,2
4724,54,30,960.9005890258258,5,3,1,9,2
4725,16,37,524.0402548988731,5,4,1,10,1
4726,8,16,2814.7886881660033,5,2,3,10,1
4727,104,15,2971.222721182267,4,2,3,9,2
4728,59,5,4219.013880414112,5,1,5,11,1
4729,313,3,2094.513500454376,1,1,3,5,3
4730,40,23,2666.599718241494,5,3,3,11,1
4731,237,10,4956.607256461444,2,1,5,8,2
4732,94,5,2663.9069659623037,4,1,3,8,2
4733,222,23,2872.1446778825602,2,3,3,8,2
4734,204,15,4979.627900238146,3,2,5,10,1
4735,138,18,4970.705613434366,4,2,5,11,1
4736,300,25,2125.911923530462,1,3,3,7,2
4737,207,8,3178.3846797187925,3,1,4,8,2
4738,336,31,2409.2045141078934,1,4,3,8,2
4739,81,21,3606.3701037694295,4,3,4,11,1
4740,218,2,4692.548740455623,2,1,5,8,2
4741,2,22,1555.1999487826336,5,3,2,10,1
4742,178,8,4096.187100490317,3,1,5,9,2
4743,346,23,3277.6961745521407,1,3,4,8,2
4744,279,32,1408.1221583583442,2,4,2,8,2
4745,146,8,3988.5252943281484,4,1,4,9,2
4746,318,4,2141.393765795882,1,1,3,5,3
4747,224,30,610.7819056516616,2,3,1,6,3
4748,62,19,4967.147622806288,5,2,5,12,1
4749,294,23,2133.9752015318713,1,3,3,7,2
4750,239,18,2712.347211407045,2,2,3,7,2
4751,195,29,4041.7290365111658,3,3,5,11,1
4752,166,23,4804.7719142484675,3,3,5,11,1
4753,222,33,4365.710371301975,2,4,5,11,1
4754,61,47,2630.0155069298175,5,5,3,13,0
4755,129,18,2733.023416910245,4,2,3,9,2
4756,173,44,1411.625813682218,3,5,2,10,1
4757,156,33,2319.3863620138277,3,4,3,10,1
4758,110,7,4734.726022053986,4,1,5,10,1
4759,269,28,3637.435310253895,2,3,4,9,2
4760,356,1,69.26618380024928,1,1,1,3,3
4761,278,39,591.3688412954775,2,4,1,7,2
4762,74,34,4619.818237089697,4,4,5,13,0
4763,207,39,4245.109451348794,3,4,5,12,1
4764,279,19,2435.9606840845004,2,2,3,7,2
4765,326,31,3088.7216215276203,1,4,4,9,2
4766,340,13,1455.3335917998172,1,2,2,5,3
4767,357,24,3966.2254529811157,1,3,4,8,2
4768,340,5,3020.554059978305,1,1,3,5,3
4769,204,23,3477.1802702250166,3,3,4,10,1
4770,161,19,1880.8000916648996,3,2,2,7,2
4771,28,1,2157.885652492288,5,1,3,9,2
4772,257,33,1046.3335939926394,2,4,2,8,2
4773,165,33,4740.78218917515,3,4,5,12,1
4774,63,32,4733.3195317290065,5,4,5,14,0
4775,22,28,4090.5787237271215,5,3,5,13,0
4776,70,37,4678.420044803927,5,4,5,14,0
4777,96,41,3329.98698237609,4,5,4,13,0
4778,163,12,1180.9128278223432,3,2,2,7,2
4779,79,9,3803.450505740531,4,1,4,9,2
4780,5,11,1633.128284116095,5,2,2,9,2
4781,316,33,2208.0036295990867,1,4,3,8,2
4782,120,19,1379.0073176382948,4,2,2,8,2
4783,302,42,2123.8733694291354,1,5,3,9,2
4784,178,34,3399.793654626908,3,4,4,11,1
4785,176,7,561.9467009120985,3,1,1,5,3
4786,217,31,534.9825756751519,3,4,1,8,2
4787,56,2,3422.0123603198285,5,1,4,10,1
4788,187,19,3900.1100222052914,3,2,4,9,2
4789,232,38,2761.8187567147015,2,4,3,9,2
4790,255,32,916.3886601966527,2,4,1,7,2
4791,104,10,2159.476673321332,4,1,3,8,2
4792,77,41,3793.295856696232,4,5,4,13,0
4793,230,8,3431.808176746974,2,1,4,7,2
4794,258,26,558.2287343186566,2,3,1,6,3
4795,264,30,4846.044432981643,2,3,5,10,1
4796,331,11,1124.5857656228193,1,2,2,5,3
4797,182,41,1109.743627856469,3,5,2,10,1
4798,256,20,2304.687666249825,2,2,3,7,2
4799,38,20,1642.943213710242,5,2,2,9,2
4800,176,9,4920.090083335526,3,1,5,9,2
4801,27,8,391.68396853811856,5,1,1,7,2
4802,276,15,1539.131562707155,2,2,2,6,3
4803,140,34,1919.783580532207,4,4,2,10,1
4804,299,24,2472.360378672483,1,3,3,7,2
4805,287,33,91.86807934747428,2,4,1,7,2
4806,91,41,420.98703772332,4,5,1,10,1
4807,61,41,1296.4701172217597,5,5,2,12,1
4808,347,45,2774.470387611125,1,5,3,9,2
4809,163,40,3841.180135265427,3,4,4,11,1
4810,351,27,3435.6117905865967,1,3,4,8,2
4811,143,21,2839.4543144858267,4,3,3,10,1
4812,253,5,1992.19187024102,2,1,2,5,3
4813,269,35,4354.765566258207,2,4,5,11,1
4814,291,21,2304.2649908587196,2,3,3,8,2
4815,187,4,1503.2714999885607,3,1,2,6,3
4816,304,49,3150.382223111766,1,5,4,10,1
4817,291,48,3463.6538329656814,2,5,4,11,1
4818,86,16,1998.3665218456886,4,2,2,8,2
4819,166,31,150.4349724191137,3,4,1,8,2
4820,114,26,479.7161861811858,4,3,1,8,2
4821,356,35,4229.5384705493725,1,4,5,10,1
4822,183,6,292.1741267146866,3,1,1,5,3
4823,207,33,2964.17813854024,3,4,3,10,1
4824,256,21,926.7098333924654,2,3,1,6,3
4825,235,16,1152.3421933084435,2,2,2,6,3
4826,355,47,1373.936459083544,1,5,2,8,2
4827,3,39,201.074017123132,5,4,1,10,1
4828,208,34,894.404017960059,3,4,1,8,2
4829,197,42,3255.994922724563,3,5,4,12,1
4830,341,15,2498.5985096779455,1,2,3,6,3
4831,125,6,3988.6721378372895,4,1,4,9,2
4832,138,2,315.59811169195274,4,1,1,6,3
4833,339,24,4445.602498295639,1,3,5,9,2
4834,25,49,4982.028674178369,5,5,5,15,0
4835,68,28,88.5424615214271,5,3,1,9,2
4836,61,1,4838.523927044267,5,1,5,11,1
4837,29,1,1186.95493772539,5,1,2,8,2
4838,19,28,3465.7902596481244,5,3,4,12,1
4839,171,36,1469.492381093582,3,4,2,9,2
4840,74,20,2613.846264950127,4,2,3,9,2
4841,61,48,2556.9883640824673,5,5,3,13,0
4842,153,8,1811.91634245087,3,1,2,6,3
4843,276,1,3590.5583737587854,2,1,4,7,2
4844,48,26,3002.1860444979384,5,3,3,11,1
4845,211,43,2546.3022496764465,3,5,3,11,1
4846,343,49,4914.368166472101,1,5,5,11,1
4847,139,25,4700.646537674758,4,3,5,12,1
4848,110,10,4777.624870510371,4,1,5,10,1
4849,183,12,4407.806559418406,3,2,5,10,1
4850,28,41,1283.2251403843552,5,5,2,12,1
4851,197,7,1756.380394581123,3,1,2,6,3
4852,191,12,1162.9625515320843,3,2,2,7,2
4853,315,47,4931.022667242004,1,5,5,11,1
4854,51,40,771.7827301198209,5,4,1,10,1
4855,149,17,1838.8936602389388,3,2,2,7,2
4856,268,5,1003.2316793495887,2,1,1,4,3
4857,50,14,1125.0345227994235,5,2,2,9,2
4858,246,34,1242.9685451680255,2,4,2,8,2
4859,113,48,3201.956671044171,4,5,4,13,0
4860,170,17,389.4863572557237,3,2,1,6,3
4861,166,35,2866.9240693826823,3,4,3,10,1
4862,14,1,4098.238319057675,5,1,5,11,1
4863,203,36,3834.9536452561097,3,4,4,11,1
4864,288,15,764.3467744288041,2,2,1,5,3
4865,189,19,4574.511356546238,3,2,5,10,1
4866,155,42,3852.7510032098226,3,5,4,12,1
4867,55,5,36.45952955490184,5,1,1,7,2
4868,182,19,3689.4944313625347,3,2,4,9,2
4869,210,43,3689.7341763237728,3,5,4,12,1
4870,75,39,2489.112241894524,4,4,3,11,1
4871,277,5,239.45225587179732,2,1,1,4,3
4872,133,12,2903.730632028924,4,2,3,9,2
4873,343,19,3831.076332571203,1,2,4,7,2
4874,59,47,1361.661536051793,5,5,2,12,1
4875,345,12,3338.670409076419,1,2,4,7,2
4876,182,36,1776.0917132714658,3,4,2,9,2
4877,339,12,2873.5356161821337,1,2,3,6,3
4878,321,18,1928.9830896638073,1,2,2,5,3
4879,64,49,1525.7697154287177,5,5,2,12,1
4880,327,48,4281.013232405901,1,5,5,11,1
4881,260,43,3771.652913335029,2,5,4,11,1
4882,193,34,1733.7911785260137,3,4,2,9,2
4883,143,48,2178.811891659893,4,5,3,12,1
4884,104,33,3461.6000551979764,4,4,4,12,1
4885,214,49,4057.2831151466407,3,5,5,13,0
4886,242,18,3424.862901495315,2,2,4,8,2
4887,209,29,2709.2485876063656,3,3,3,9,2
4888,93,45,4772.385301337045,4,5,5,14,0
4889,142,5,3872.9766625104025,4,1,4,9,2
4890,112,25,586.8033833525304,4,3,1,8,2
4891,59,24,2795.1141029721757,5,3,3,11,1
4892,43,29,2053.687640564301,5,3,3,11,1
4893,207,38,3976.7288275860606,3,4,4,11,1
4894,268,33,232.86853894858558,2,4,1,7,2
4895,296,10,2059.510614112516,1,1,3,5,3
4896,118,37,1598.1988135639945,4,4,2,10,1
4897,20,33,714.5180630527944,5,4,1,10,1
4898,222,23,1900.2325354446643,2,3,2,7,2
4899,166,11,3367.2733881405507,3,2,4,9,2
4900,131,24,1814.7726463123063,4,3,2,9,2
4901,156,24,2904.2328110083026,3,3,3,9,2
4902,184,7,2968.1308617371524,3,1,3,7,2
4903,90,21,2939.6845240195858,4,3,3,10,1
4904,94,20,2652.3641008815853,4,2,3,9,2
4905,13,10,593.7712960551157,5,1,1,7,2
4906,322,25,1100.0950779022764,1,3,2,6,3
4907,293,47,4002.334710492436,1,5,4,10,1
4908,230,36,2516.803789724324,2,4,3,9,2
4909,322,48,3533.320816023212,1,5,4,10,1
4910,292,47,2853.8463102616806,1,5,3,9,2
4911,26,15,203.06436995618927,5,2,1,8,2
4912,75,44,3983.1067073993236,4,5,4,13,0
4913,364,40,330.97773069995685,1,4,1,6,3
4914,299,40,4716.43851528128,1,4,5,10,1
4915,150,6,1084.7308393083283,3,1,2,6,3
4916,148,37,2566.906655866146,3,4,3,10,1
4917,8,2,327.3043319042748,5,1,1,7,2
4918,29,12,4475.712569542447,5,2,5,12,1
4919,296,4,4899.901870278374,1,1,5,7,2
4920,209,23,739.9995885787375,3,3,1,7,2
4921,128,13,1485.9748470426637,4,2,2,8,2
4922,340,17,89.21336475130049,1,2,1,4,3
4923,116,31,3936.957804917608,4,4,4,12,1
4924,144,16,1564.2070200802489,4,2,2,8,2
4925,318,41,2948.298972015738,1,5,3,9,2
4926,235,26,205.70032138727277,2,3,1,6,3
4927,7,28,3580.14673070699,5,3,4,12,1
4928,45,1,2651.725777150067,5,1,3,9,2
4929,239,47,3627.6514275341874,2,5,4,11,1
4930,155,12,3949.92592262331,3,2,4,9,2
4931,181,37,455.3219022323802,3,4,1,8,2
4932,215,20,2894.6796827581934,3,2,3,8,2
4933,88,2,3253.2207290692927,4,1,4,9,2
4934,256,36,2588.426582185525,2,4,3,9,2
4935,73,15,920.2228973429601,5,2,1,8,2
4936,179,38,3980.0304474481077,3,4,4,11,1
4937,212,22,4987.317060909596,3,3,5,11,1
4938,293,44,4846.658559618329,1,5,5,11,1
4939,234,32,3889.8725292363843,2,4,4,10,1
4940,239,20,2096.357536704243,2,2,3,7,2
4941,223,36,1693.1294842217105,2,4,2,8,2
4942,119,33,352.04353751315074,4,4,1,9,2
4943,313,15,2087.268655720935,1,2,3,6,3
4944,264,46,788.6825026816771,2,5,1,8,2
4945,207,3,1279.1302203950818,3,1,2,6,3
4946,95,29,4460.514998154982,4,3,5,12,1
4947,222,47,4842.942901240983,2,5,5,12,1
4948,276,27,4743.309412324144,2,3,5,10,1
4949,231,5,974.8448723585207,2,1,1,4,3
4950,309,31,4505.462099094261,1,4,5,10,1
4951,119,22,716.111451492323,4,3,1,8,2
4952,268,35,2543.2244373019876,2,4,3,9,2
4953,273,7,3221.8802026492235,2,1,4,7,2
4954,64,6,2317.7096967710895,5,1,3,9,2
4955,298,26,4759.668802729874,1,3,5,9,2
4956,350,1,1672.7314882271094,1,1,2,4,3
4957,11,19,2641.6145388593372,5,2,3,10,1
4958,98,7,386.49517804352143,4,1,1,6,3
4959,71,36,4262.600654590004,5,4,5,14,0
4960,364,12,2072.683345760284,1,2,3,6,3
4961,58,20,3505.655256804067,5,2,4,11,1
4962,290,23,3414.405698936597,2,3,4,9,2
4963,251,25,3384.5518352428917,2,3,4,9,2
4964,276,30,2539.6220109996307,2,3,3,8,2
4965,50,29,1394.818764833725,5,3,2,10,1
4966,358,31,3129.221847221318,1,4,4,9,2
4967,216,18,4809.339604017979,3,2,5,10,1
4968,52,41,4171.406787172106,5,5,5,15,0
4969,271,19,552.7534754533451,2,2,1,5,3
4970,84,4,125.70513391688492,4,1,1,6,3
4971,293,1,2499.867070783469,1,1,3,5,3
4972,126,41,3881.3884650565333,4,5,4,13,0
4973,296,15,1576.3737403043642,1,2,2,5,3
4974,72,8,3509.1790067420957,5,1,4,10,1
4975,296,15,4660.287108551657,1,2,5,8,2
4976,236,15,2300.3326896039976,2,2,3,7,2
4977,56,39,1228.356684590803,5,4,2,11,1
4978,360,22,4589.611731780433,1,3,5,9,2
4979,110,18,2366.597180378537,4,2,3,9,2
4980,192,16,2045.1181403087992,3,2,3,8,2
4981,93,2,1773.2742419892106,4,1,2,7,2
4982,350,36,2120.8545926696775,1,4,3,8,2
4983,56,20,3371.5526923699676,5,2,4,11,1
4984,60,16,2174.2609398285686,5,2,3,10,1
4985,138,3,1627.8772039105083,4,1,2,7,2
4986,39,30,3720.7519511430005,5,3,4,12,1
4987,28,2,1022.827420851737,5,1,1,7,2
4988,49,35,1017.6492859580317,5,4,1,10,1
4989,125,26,3485.2133273792942,4,3,4,11,1
4990,13,5,4334.865585645472,5,1,5,11,1
4991,36,2,1213.6420890906757,5,1,2,8,2
4992,101,20,963.7136251323834,4,2,1,7,2
4993,282,34,3354.826347640854,2,4,4,10,1
4994,86,34,3107.8045836480323,4,4,4,12,1
4995,4,20,2241.789209132865,5,2,3,10,1
4996,223,25,488.34459284315636,2,3,1,6,3
4997,338,20,468.00930059954834,1,2,1,4,3
4998,166,25,3888.935527331329,3,3,4,10,1
4999,344,14,2264.3278958044707,1,2,3,6,3
5000,278,47,4291.255785295379,2,5,5,12,1
5001,130,44,2877.920921178923,4,5,3,12,1
5002,31,43,3097.503324675987,5,5,4,14,0
5003,11,43,4671.630265123683,5,5,5,15,0
5004,302,39,831.4333112567956,1,4,1,6,3
5005,96,12,2719.6909041920094,4,2,3,9,2
5006,190,48,300.1116138305135,3,5,1,9,2
5007,192,5,1801.0359889317742,3,1,2,6,3
5008,266,2,749.0115140080137,2,1,1,4,3
5009,128,16,947.301451800007,4,2,1,7,2
5010,238,30,4674.625653102035,2,3,5,10,1
5011,355,47,3057.305815742355,1,5,4,10,1
5012,112,43,4461.869084617173,4,5,5,14,0
5013,316,38,2223.1657201098405,1,4,3,8,2
5014,343,45,2992.240299850283,1,5,3,9,2
5015,145,42,170.15161584270254,4,5,1,10,1
5016,65,24,2352.816139048927,5,3,3,11,1
5017,247,30,2824.642799985503,2,3,3,8,2
5018,223,37,93.72079418506942,2,4,1,7,2
5019,313,39,3949.550992349965,1,4,4,9,2
5020,106,11,1484.1606915402615,4,2,2,8,2
5021,181,14,2267.9105040542436,3,2,3,8,2
5022,184,23,2682.795123671074,3,3,3,9,2
5023,226,16,4961.063794110883,2,2,5,9,2
5024,265,21,504.9288929021725,2,3,1,6,3
5025,278,4,2780.845015500245,2,1,3,6,3
5026,89,33,2657.6647875433437,4,4,3,11,1
5027,176,47,353.859381059879,3,5,1,9,2
5028,18,14,3173.352417373672,5,2,4,11,1
5029,106,19,1441.403625130115,4,2,2,8,2
5030,271,5,527.8021511614572,2,1,1,4,3
5031,319,36,901.423235283079,1,4,1,6,3
5032,167,31,4119.78013374481,3,4,5,12,1
5033,13,45,529.5825645625955,5,5,1,11,1
5034,337,18,2339.96766731922,1,2,3,6,3
5035,32,44,984.412874684314,5,5,1,11,1
5036,40,31,819.9761118042101,5,4,1,10,1
5037,148,30,1036.501679491192,3,3,2,8,2
5038,218,21,2468.986843252905,2,3,3,8,2
5039,219,47,1196.5642213467406,2,5,2,9,2
5040,82,30,492.69742225927615,4,3,1,8,2
5041,333,41,4008.9903375433714,1,5,4,10,1
5042,208,4,2703.708801826712,3,1,3,7,2
5043,201,5,792.6997253191752,3,1,1,5,3
5044,332,41,2362.4349446745287,1,5,3,9,2
5045,38,45,351.1288743658203,5,5,1,11,1
5046,211,10,2906.345019457605,3,1,3,7,2
5047,327,27,1708.1210497939278,1,3,2,6,3
5048,249,16,526.607362854519,2,2,1,5,3
5049,227,30,926.3828108433032,2,3,1,6,3
5050,48,13,1735.0564972051254,5,2,2,9,2
5051,18,36,4033.9731969182917,5,4,5,14,0
5052,295,21,877.0409241868185,1,3,1,5,3
5053,196,45,557.2244652490635,3,5,1,9,2
5054,187,40,2584.535642263764,3,4,3,10,1
5055,345,45,2797.8978502615214,1,5,3,9,2
5056,224,15,460.30417516041166,2,2,1,5,3
5057,318,20,1429.577551244437,1,2,2,5,3
5058,337,20,1321.192549192128,1,2,2,5,3
5059,229,45,939.2458312109654,2,5,1,8,2
5060,77,5,1585.0342547312623,4,1,2,7,2
5061,188,32,195.17147257610023,3,4,1,8,2
5062,346,6,3261.2334169378573,1,1,4,6,3
5063,270,30,4942.550853718867,2,3,5,10,1
5064,95,26,3173.8933696715517,4,3,4,11,1
5065,310,37,1811.7714882134933,1,4,2,7,2
5066,132,13,3342.8724027169274,4,2,4,10,1
5067,39,29,2861.864445907646,5,3,3,11,1
5068,72,5,4235.322073630849,5,1,5,11,1
5069,281,25,3113.1540593001823,2,3,4,9,2
5070,333,13,3174.041009560031,1,2,4,7,2
5071,160,24,1116.104299482237,3,3,2,8,2
5072,187,31,2083.97992030259,3,4,3,10,1
5073,191,20,1728.636140675829,3,2,2,7,2
5074,120,8,67.01168514471739,4,1,1,6,3
5075,220,9,1573.2708396514163,2,1,2,5,3
5076,53,21,2435.4500003715216,5,3,3,11,1
5077,222,20,3003.2446797183047,2,2,3,7,2
5078,131,15,4673.499044085172,4,2,5,11,1
5079,237,26,1203.1776592054837,2,3,2,7,2
5080,246,42,770.6206656317062,2,5,1,8,2
5081,226,11,4348.533988104801,2,2,5,9,2
5082,208,37,4709.818995501353,3,4,5,12,1
5083,96,41,2444.891700419611,4,5,3,12,1
5084,200,11,584.9306406377593,3,2,1,6,3
5085,247,27,2432.0876133920865,2,3,3,8,2
5086,72,30,556.1222022453111,5,3,1,9,2
5087,318,19,4417.096037716307,1,2,5,8,2
5088,185,34,3543.6690220350874,3,4,4,11,1
5089,6,38,1213.2737183729198,5,4,2,11,1
5090,206,23,4434.586559650766,3,3,5,11,1
5091,32,1,3193.1296279561034,5,1,4,10,1
5092,99,3,4766.784050237134,4,1,5,10,1
5093,256,3,4902.59444656263,2,1,5,8,2
5094,187,28,26.376128286233275,3,3,1,7,2
5095,76,14,609.8689030474534,4,2,1,7,2
5096,177,30,2739.1424307261104,3,3,3,9,2
5097,315,5,4779.705843591784,1,1,5,7,2
5098,287,49,4971.225841193381,2,5,5,12,1
5099,349,15,2841.3655971645644,1,2,3,6,3
5100,255,38,877.2694298366991,2,4,1,7,2
5101,325,14,823.6195998434438,1,2,1,4,3
5102,190,14,3821.6502129895503,3,2,4,9,2
5103,308,49,2963.7690167444257,1,5,3,9,2
5104,345,8,2748.381755674487,1,1,3,5,3
5105,127,8,2334.1669672695766,4,1,3,8,2
5106,287,19,3628.421786642591,2,2,4,8,2
5107,254,32,4291.6903532416645,2,4,5,11,1
5108,213,31,1521.760825166225,3,4,2,9,2
5109,250,29,1112.3796582076943,2,3,2,7,2
5110,84,41,3354.2938399115624,4,5,4,13,0
5111,13,11,4574.514796034217,5,2,5,12,1
5112,45,45,1747.3056263189903,5,5,2,12,1
5113,127,13,1369.5166136953026,4,2,2,8,2
5114,114,27,1138.3120048757414,4,3,2,9,2
5115,276,19,1279.909629406188,2,2,2,6,3
5116,205,26,683.3173813719691,3,3,1,7,2
5117,337,37,2987.923355765684,1,4,3,8,2
5118,273,48,1411.322082619666,2,5,2,9,2
5119,58,9,3078.572364672944,5,1,4,10,1
5120,328,28,424.33142406771486,1,3,1,5,3
5121,219,32,586.1293926682166,2,4,1,7,2
5122,109,3,2685.3482197067533,4,1,3,8,2
5123,279,32,2562.53941293531,2,4,3,9,2
5124,174,5,1364.8345344220643,3,1,2,6,3
5125,328,8,4137.382949586507,1,1,5,7,2
5126,264,14,943.3653526890719,2,2,1,5,3
5127,315,3,1809.6990096740985,1,1,2,4,3
5128,111,24,2782.003413301287,4,3,3,10,1
5129,187,13,4337.3834015516695,3,2,5,10,1
5130,269,43,2098.5693660822153,2,5,3,10,1
5131,229,29,1999.0187676501127,2,3,2,7,2
5132,156,8,2901.8917658786554,3,1,3,7,2
5133,189,42,1590.3101231598523,3,5,2,10,1
5134,272,31,3548.774533266351,2,4,4,10,1
5135,2,26,1250.9927439283535,5,3,2,10,1
5136,246,18,4117.748024731659,2,2,5,9,2
5137,210,18,1369.0435315359712,3,2,2,7,2
5138,286,7,4963.5787998296555,2,1,5,8,2
5139,359,48,1589.1477468949367,1,5,2,8,2
5140,13,38,4395.342431889437,5,4,5,14,0
5141,96,48,1992.8062109892257,4,5,2,11,1
5142,221,16,1237.8136617343423,2,2,2,6,3
5143,238,33,1138.5546197971726,2,4,2,8,2
5144,94,3,4252.4544964308925,4,1,5,10,1
5145,338,38,1550.677401701255,1,4,2,7,2
5146,269,4,1699.4294147091375,2,1,2,5,3
5147,171,36,992.9953486363133,3,4,1,8,2
5148,94,4,4807.010343399922,4,1,5,10,1
5149,149,42,1231.272263588162,3,5,2,10,1
5150,112,9,1244.7436587182442,4,1,2,7,2
5151,55,40,4720.050472370932,5,4,5,14,0
5152,337,17,4505.485286425963,1,2,5,8,2
5153,116,17,1252.0653070677517,4,2,2,8,2
5154,143,33,4324.980591894767,4,4,5,13,0
5155,201,20,1256.6178332997233,3,2,2,7,2
5156,180,14,431.47618261584347,3,2,1,6,3
5157,202,22,4103.603128495168,3,3,5,11,1
5158,364,27,3860.0752074982784,1,3,4,8,2
5159,53,43,1480.3889372404426,5,5,2,12,1
5160,180,3,459.79353576182046,3,1,1,5,3
5161,313,24,1040.1300335409674,1,3,2,6,3
5162,308,30,3857.572288823262,1,3,4,8,2
5163,137,8,4824.091596562709,4,1,5,10,1
5164,182,22,1302.4203382545127,3,3,2,8,2
5165,1,25,4093.111417166891,5,3,5,13,0
5166,44,10,1147.3839601124005,5,1,2,8,2
5167,227,49,3401.205955207167,2,5,4,11,1
5168,331,29,427.2312104673164,1,3,1,5,3
5169,98,40,2930.6252455074773,4,4,3,11,1
5170,208,1,1353.2575570616436,3,1,2,6,3
5171,265,21,4629.971284180949,2,3,5,10,1
5172,288,39,1455.8569350069786,2,4,2,8,2
5173,271,24,1998.21906736291,2,3,2,7,2
5174,140,9,4204.988764661359,4,1,5,10,1
5175,237,44,2196.9901669085034,2,5,3,10,1
5176,72,26,1199.677136456643,5,3,2,10,1
5177,155,9,2742.246161262543,3,1,3,7,2
5178,190,20,4201.5560662934095,3,2,5,10,1
5179,268,35,2171.5562839032154,2,4,3,9,2
5180,321,36,673.1135611322894,1,4,1,6,3
5181,107,42,1921.6036964414388,4,5,2,11,1
5182,232,36,4772.830914140015,2,4,5,11,1
5183,42,9,369.3878856252033,5,1,1,7,2
5184,190,22,2048.141410515619,3,3,3,9,2
5185,139,1,3243.6636817614253,4,1,4,9,2
5186,103,5,401.803453796996,4,1,1,6,3
5187,171,9,1731.3132095453097,3,1,2,6,3
5188,351,37,4703.485986161913,1,4,5,10,1
5189,273,38,162.87210410865487,2,4,1,7,2
5190,221,19,3761.191978734656,2,2,4,8,2
5191,213,8,4208.4610810186205,3,1,5,9,2
5192,341,42,1392.5330198345735,1,5,2,8,2
5193,56,43,1081.4247039038632,5,5,2,12,1
5194,342,32,4574.956258995174,1,4,5,10,1
5195,102,13,3822.368460448815,4,2,4,10,1
5196,192,20,575.7697409389415,3,2,1,6,3
5197,310,36,1068.8643050268504,1,4,2,7,2
5198,200,43,3110.562223412847,3,5,4,12,1
5199,233,44,2102.8904751954933,2,5,3,10,1
5200,227,37,2525.83010848512,2,4,3,9,2
5201,139,30,4758.196751160315,4,3,5,12,1
5202,344,10,2106.97496132795,1,1,3,5,3
5203,305,31,4409.593159113202,1,4,5,10,1
5204,149,25,3307.1161461162606,3,3,4,10,1
5205,115,29,616.8810989806453,4,3,1,8,2
5206,63,24,3725.090112872121,5,3,4,12,1
5207,104,39,2605.8432790420106,4,4,3,11,1
5208,339,21,1133.235279456023,1,3,2,6,3
5209,359,41,1454.8511221806675,1,5,2,8,2
5210,156,9,2791.088799506249,3,1,3,7,2
5211,273,42,3012.495425827507,2,5,3,10,1
5212,6,42,4841.200256107105,5,5,5,15,0
5213,147,2,4275.053480688861,3,1,5,9,2
5214,184,4,1037.1380421064282,3,1,2,6,3
5215,28,8,3872.220432130056,5,1,4,10,1
5216,38,32,51.37612267671125,5,4,1,10,1
5217,119,14,657.7442212140685,4,2,1,7,2
5218,293,49,1006.5050761707531,1,5,1,7,2
5219,244,13,2990.0247697690984,2,2,3,7,2
5220,68,21,981.4781814379317,5,3,1,9,2
5221,214,24,1832.7119807561826,3,3,2,8,2
5222,218,18,1221.4711128889767,2,2,2,6,3
5223,177,45,1693.708955656017,3,5,2,10,1
5224,299,40,4712.832709222989,1,4,5,10,1
5225,164,26,4986.907999451197,3,3,5,11,1
5226,58,32,3431.753310257905,5,4,4,13,0
5227,269,44,2865.8162785638474,2,5,3,10,1
5228,308,33,3545.154750623253,1,4,4,9,2
5229,58,31,3860.544480090353,5,4,4,13,0
5230,288,18,3697.673590611477,2,2,4,8,2
5231,105,35,418.643715718024,4,4,1,9,2
5232,228,12,1558.3641622410023,2,2,2,6,3
5233,247,25,1723.7225951308512,2,3,2,7,2
5234,188,45,1852.5798260092047,3,5,2,10,1
5235,83,31,1728.1257554711947,4,4,2,10,1
5236,186,10,3937.590564277135,3,1,4,8,2
5237,252,47,3740.547292743048,2,5,4,11,1
5238,355,34,32.955511434332415,1,4,1,6,3
5239,238,3,1488.943802238648,2,1,2,5,3
5240,360,46,3122.0816024487744,1,5,4,10,1
5241,184,39,610.1254537241097,3,4,1,8,2
5242,284,8,365.27948948280664,2,1,1,4,3
5243,210,32,4143.706616297423,3,4,5,12,1
5244,304,43,2268.894518138625,1,5,3,9,2
5245,296,29,4279.879965925059,1,3,5,9,2
5246,97,22,4119.528108611063,4,3,5,12,1
5247,208,20,4467.918905481522,3,2,5,10,1
5248,137,6,250.89007216762892,4,1,1,6,3
5249,184,43,938.7890298808389,3,5,1,9,2
5250,76,49,1487.7543903630883,4,5,2,11,1
5251,287,29,689.789635310922,2,3,1,6,3
5252,142,42,2432.494405720714,4,5,3,12,1
5253,237,17,3996.8946812949025,2,2,4,8,2
5254,25,31,4756.397236140026,5,4,5,14,0
5255,290,34,4448.9749310375655,2,4,5,11,1
5256,67,38,2292.1100332788833,5,4,3,12,1
5257,250,37,3186.0905958410517,2,4,4,10,1
5258,118,4,1161.1736560087777,4,1,2,7,2
5259,73,2,2021.0149096602802,5,1,3,9,2
5260,282,12,4357.201151145816,2,2,5,9,2
5261,360,35,155.6956348772091,1,4,1,6,3
5262,10,6,2668.468770490937,5,1,3,9,2
5263,211,46,4365.263506516117,3,5,5,13,0
5264,323,8,618.8292705152946,1,1,1,3,3
5265,152,21,4912.905547736099,3,3,5,11,1
5266,5,46,71.83340526603428,5,5,1,11,1
5267,195,35,4431.73885720119,3,4,5,12,1
5268,283,48,1774.826146230885,2,5,2,9,2
5269,113,15,672.1260025720359,4,2,1,7,2
5270,271,7,795.2172945201302,2,1,1,4,3
5271,163,15,3508.8818045878115,3,2,4,9,2
5272,105,45,4354.891186513161,4,5,5,14,0
5273,181,6,3208.9211054958714,3,1,4,8,2
5274,44,47,4644.337607090157,5,5,5,15,0
5275,282,17,4213.969187333926,2,2,5,9,2
5276,175,4,55.068716633845604,3,1,1,5,3
5277,162,22,3350.4540255063725,3,3,4,10,1
5278,351,32,1530.12709668432,1,4,2,7,2
5279,340,22,2277.9550584848466,1,3,3,7,2
5280,140,27,479.21343318979143,4,3,1,8,2
5281,132,46,1417.6748177395355,4,5,2,11,1
5282,87,15,3167.102977488212,4,2,4,10,1
5283,176,44,1099.726829979057,3,5,2,10,1
5284,183,22,3241.2079746732534,3,3,4,10,1
5285,129,28,4615.930532275395,4,3,5,12,1
5286,246,42,34.6521219747366,2,5,1,8,2
5287,89,38,3930.995891451993,4,4,4,12,1
5288,66,9,3210.1812120143095,5,1,4,10,1
5289,158,34,242.6974860416233,3,4,1,8,2
5290,149,36,3952.9340148536494,3,4,4,11,1
5291,340,9,1130.359965334284,1,1,2,4,3
5292,116,15,1336.444498205898,4,2,2,8,2
5293,214,45,476.6432555221731,3,5,1,9,2
5294,294,20,2676.5552785628643,1,2,3,6,3
5295,253,8,2496.136463938451,2,1,3,6,3
5296,143,28,1742.400786618082,4,3,2,9,2
5297,250,19,852.0815007561976,2,2,1,5,3
5298,302,16,4191.388236950338,1,2,5,8,2
5299,25,11,4383.128366037682,5,2,5,12,1
5300,277,42,2707.4922574612237,2,5,3,10,1
5301,70,8,1228.684414660897,5,1,2,8,2
5302,113,33,489.589227836433,4,4,1,9,2
5303,363,10,4344.035395782898,1,1,5,7,2
5304,112,18,489.30307075187596,4,2,1,7,2
5305,364,35,75.76838836976205,1,4,1,6,3
5306,303,43,2352.2939109198073,1,5,3,9,2
5307,91,3,3659.0423996768777,4,1,4,9,2
5308,18,40,2293.1096523404326,5,4,3,12,1
5309,149,27,266.53892886281517,3,3,1,7,2
5310,227,28,3453.245275974896,2,3,4,9,2
5311,214,46,3215.239776583676,3,5,4,12,1
5312,360,6,3410.833358311529,1,1,4,6,3
5313,151,47,1063.9004318317568,3,5,2,10,1
5314,192,14,3980.5350616345436,3,2,4,9,2
5315,40,7,2401.0493766231857,5,1,3,9,2
5316,242,10,2686.400524846297,2,1,3,6,3
5317,138,15,2733.691748174703,4,2,3,9,2
5318,345,31,1441.164120985293,1,4,2,7,2
5319,180,29,1258.1691806418412,3,3,2,8,2
5320,200,42,33.782991102866646,3,5,1,9,2
5321,203,17,1989.0856068564478,3,2,2,7,2
5322,61,29,2430.6638898559368,5,3,3,11,1
5323,192,49,3716.59069081994,3,5,4,12,1
5324,5,44,342.46853511205694,5,5,1,11,1
5325,237,15,4620.707167869569,2,2,5,9,2
5326,181,26,1327.1527565527372,3,3,2,8,2
5327,311,12,1839.9362437399566,1,2,2,5,3
5328,37,25,251.3287033203564,5,3,1,9,2
5329,56,41,3269.1506899824353,5,5,4,14,0
5330,237,5,3547.524758975436,2,1,4,7,2
5331,358,4,4644.66817427593,1,1,5,7,2
5332,349,44,1690.7767265429918,1,5,2,8,2
5333,197,48,1294.269962092385,3,5,2,10,1
5334,73,41,3633.171652818645,5,5,4,14,0
5335,59,31,3536.93643333021,5,4,4,13,0
5336,240,3,4686.249048688401,2,1,5,8,2
5337,2,3,1034.539934924087,5,1,2,8,2
5338,360,26,3529.4101872457304,1,3,4,8,2
5339,188,17,343.6742001748776,3,2,1,6,3
5340,307,10,2407.036852718521,1,1,3,5,3
5341,30,2,605.7599785558847,5,1,1,7,2
5342,267,24,3269.198480591415,2,3,4,9,2
5343,108,11,3011.319140841512,4,2,3,9,2
5344,332,24,253.67633881234585,1,3,1,5,3
5345,90,35,1604.892934697933,4,4,2,10,1
5346,205,23,1981.217825060996,3,3,2,8,2
5347,220,32,1247.8207448696926,2,4,2,8,2
5348,94,23,202.96351965386256,4,3,1,8,2
5349,103,34,1600.9212615692336,4,4,2,10,1
5350,223,41,3965.1982582396345,2,5,4,11,1
5351,186,19,1806.9443520722966,3,2,2,7,2
5352,184,2,1623.615078619423,3,1,2,6,3
5353,162,2,4709.348158178806,3,1,5,9,2
5354,247,15,217.7372863853615,2,2,1,5,3
5355,31,21,3838.7680962534955,5,3,4,12,1
5356,52,35,2420.637055588606,5,4,3,12,1
5357,345,5,4722.867912477598,1,1,5,7,2
5358,76,43,1973.419013375325,4,5,2,11,1
5359,278,27,3543.1312616575538,2,3,4,9,2
5360,40,24,358.9774683086691,5,3,1,9,2
5361,101,7,4644.574403663567,4,1,5,10,1
5362,111,6,1729.267907324977,4,1,2,7,2
5363,321,46,2624.7828331635897,1,5,3,9,2
5364,249,33,701.0232277272058,2,4,1,7,2
5365,191,49,4728.333777389002,3,5,5,13,0
5366,182,17,3368.1223156101687,3,2,4,9,2
5367,335,46,279.19790941220003,1,5,1,7,2
5368,209,42,784.4818281046241,3,5,1,9,2
5369,22,30,2005.171648236822,5,3,2,10,1
5370,166,8,1091.6873517975162,3,1,2,6,3
5371,99,40,1530.0815918864896,4,4,2,10,1
5372,208,46,4987.480892772121,3,5,5,13,0
5373,8,7,3296.6569987775147,5,1,4,10,1
5374,190,6,4611.865835549115,3,1,5,9,2
5375,175,4,2184.633890523102,3,1,3,7,2
5376,273,1,3554.3085996079335,2,1,4,7,2
5377,17,15,2303.8545578848302,5,2,3,10,1
5378,90,31,1647.8404688465703,4,4,2,10,1
5379,141,25,2600.674001040271,4,3,3,10,1
5380,145,47,2142.2820985195585,4,5,3,12,1
5381,166,33,4902.897836916662,3,4,5,12,1
5382,337,35,2485.87036202984,1,4,3,8,2
5383,78,5,4057.4545331649897,4,1,5,10,1
5384,262,5,3337.429146796284,2,1,4,7,2
5385,163,36,2403.339913714938,3,4,3,10,1
5386,14,17,2376.008861607017,5,2,3,10,1
5387,239,14,1716.031684139568,2,2,2,6,3
5388,72,29,543.83922008396,5,3,1,9,2
5389,143,8,3809.7319513972107,4,1,4,9,2
5390,310,34,4591.29301807069,1,4,5,10,1
5391,283,40,1097.594724753987,2,4,2,8,2
5392,269,1,4629.110734706695,2,1,5,8,2
5393,241,29,1169.198048110808,2,3,2,7,2
5394,245,36,2655.094718899038,2,4,3,9,2
5395,163,37,1724.6737606744177,3,4,2,9,2
5396,60,29,581.3988417021685,5,3,1,9,2
5397,6,5,273.66349102818117,5,1,1,7,2
5398,197,32,1833.0791953996948,3,4,2,9,2
5399,58,24,246.24588410170534,5,3,1,9,2
5400,305,19,529.990123313878,1,2,1,4,3
5401,217,12,720.0649182019413,3,2,1,6,3
5402,26,1,19.559373833205285,5,1,1,7,2
5403,303,7,774.7285570598307,1,1,1,3,3
5404,5,17,2890.6206150880894,5,2,3,10,1
5405,20,34,4099.420379258723,5,4,5,14,0
5406,198,43,975.2154974462685,3,5,1,9,2
5407,59,7,413.5542931990264,5,1,1,7,2
5408,242,17,3650.275850195002,2,2,4,8,2
5409,146,3,50.731930171508,4,1,1,6,3
5410,273,29,3673.4688891615424,2,3,4,9,2
5411,249,22,664.2750069757376,2,3,1,6,3
5412,14,38,1149.1424599758234,5,4,2,11,1
5413,13,43,609.1488553312674,5,5,1,11,1
5414,44,29,1244.2174036864585,5,3,2,10,1
5415,19,42,3992.8979329243566,5,5,4,14,0
5416,63,5,671.395084574128,5,1,1,7,2
5417,239,30,4970.886505144735,2,3,5,10,1
5418,337,23,1642.2179027279815,1,3,2,6,3
5419,100,21,4610.620946286561,4,3,5,12,1
5420,163,26,958.2650683793777,3,3,1,7,2
5421,122,47,947.6086245225647,4,5,1,10,1
5422,44,21,2831.0250583849383,5,3,3,11,1
5423,360,20,262.4944236743429,1,2,1,4,3
5424,317,23,4007.0044592016084,1,3,4,8,2
5425,145,4,2203.6801008335888,4,1,3,8,2
5426,327,21,3498.990402030744,1,3,4,8,2
5427,363,21,881.4146954451367,1,3,1,5,3
5428,50,1,3215.36318042309,5,1,4,10,1
5429,65,15,2974.412565214951,5,2,3,10,1
5430,355,17,3780.749647070539,1,2,4,7,2
5431,288,14,1494.0324503283432,2,2,2,6,3
5432,164,19,4666.496219107831,3,2,5,10,1
5433,141,34,4806.892336284702,4,4,5,13,0
5434,314,6,4341.93681999456,1,1,5,7,2
5435,128,45,2864.4484931411034,4,5,3,12,1
5436,239,49,2107.2384706001394,2,5,3,10,1
5437,324,6,299.3821686640747,1,1,1,3,3
5438,296,5,4736.6667292903385,1,1,5,7,2
5439,187,7,4759.3889050548505,3,1,5,9,2
5440,208,33,103.25539034862244,3,4,1,8,2
5441,220,13,1790.8688577371931,2,2,2,6,3
5442,190,1,4401.3814776087265,3,1,5,9,2
5443,346,13,413.45164486769534,1,2,1,4,3
5444,284,43,990.8662197839349,2,5,1,8,2
5445,352,27,4893.599810929758,1,3,5,9,2
5446,237,7,4237.971172480539,2,1,5,8,2
5447,194,3,4561.19683547798,3,1,5,9,2
5448,287,25,719.3505490900328,2,3,1,6,3
5449,259,33,1064.4666352445563,2,4,2,8,2
5450,246,40,3031.028755915228,2,4,3,9,2
5451,136,17,2513.673722803469,4,2,3,9,2
5452,280,45,1499.531918829774,2,5,2,9,2
5453,271,14,4420.3930356888595,2,2,5,9,2
5454,171,37,4507.929191522509,3,4,5,12,1
5455,159,23,1465.5032106315896,3,3,2,8,2
5456,201,24,787.2081715537795,3,3,1,7,2
5457,45,29,753.9711796438643,5,3,1,9,2
5458,264,38,2427.281725005776,2,4,3,9,2
5459,71,27,673.2632920527511,5,3,1,9,2
5460,364,38,2371.9677082551743,1,4,3,8,2
5461,103,40,2315.051023570689,4,4,3,11,1
5462,125,45,4421.709963896229,4,5,5,14,0
5463,313,23,1488.0900946021848,1,3,2,6,3
5464,286,31,2807.6557686184774,2,4,3,9,2
5465,230,36,3720.0643227776413,2,4,4,10,1
5466,146,17,2983.614827299033,4,2,3,9,2
5467,197,37,4770.798546450884,3,4,5,12,1
5468,221,3,3015.3646276938525,2,1,3,6,3
5469,60,36,4510.292270565858,5,4,5,14,0
5470,98,5,1232.8313823761773,4,1,2,7,2
5471,171,46,2808.1563361693875,3,5,3,11,1
5472,173,15,2721.0965735676054,3,2,3,8,2
5473,151,49,4947.366029599017,3,5,5,13,0
5474,350,6,1030.4865038616263,1,1,2,4,3
5475,122,10,713.5570578462275,4,1,1,6,3
5476,108,32,3062.243667375798,4,4,4,12,1
5477,4,23,1126.2237952269961,5,3,2,10,1
5478,93,48,3199.3851747949466,4,5,4,13,0
5479,6,17,4862.7205517125585,5,2,5,12,1
5480,288,46,4733.064917033314,2,5,5,12,1
5481,106,20,1163.2040929735501,4,2,2,8,2
5482,146,44,862.7727775786232,4,5,1,10,1
5483,271,41,2808.0890429411033,2,5,3,10,1
5484,96,15,2938.0186682335193,4,2,3,9,2
5485,229,44,3314.627856189445,2,5,4,11,1
5486,202,46,3710.039720674174,3,5,4,12,1
5487,212,22,3008.7769802533007,3,3,3,9,2
5488,6,6,567.6474885611174,5,1,1,7,2
5489,112,4,3952.8882731415447,4,1,4,9,2
5490,323,23,406.7907507778836,1,3,1,5,3
5491,106,44,109.76350422378847,4,5,1,10,1
5492,139,45,3850.594401093264,4,5,4,13,0
5493,299,19,2746.3035479340224,1,2,3,6,3
5494,96,45,3495.9711787467513,4,5,4,13,0
5495,337,31,1919.9091477959175,1,4,2,7,2
5496,297,44,65.3515426872175,1,5,1,7,2
5497,214,3,1661.7665921638165,3,1,2,6,3
5498,291,28,3044.594812286482,2,3,4,9,2
5499,22,3,1136.2583216458477,5,1,2,8,2
5500,193,14,3442.1436248283276,3,2,4,9,2
5501,150,18,3974.0610393608054,3,2,4,9,2
5502,247,27,2276.79232184414,2,3,3,8,2
5503,267,10,4379.849277365146,2,1,5,8,2
5504,251,49,4275.534657199898,2,5,5,12,1
5505,3,15,4391.50918443125,5,2,5,12,1
5506,316,19,3308.574792957607,1,2,4,7,2
5507,76,9,1530.8971083711635,4,1,2,7,2
5508,87,4,2411.443899034144,4,1,3,8,2
5509,270,15,3555.448141160146,2,2,4,8,2
5510,225,48,1060.712629780238,2,5,2,9,2
5511,18,8,3696.8291111800863,5,1,4,10,1
5512,113,49,2744.9621992942707,4,5,3,12,1
5513,251,1,489.12702701498085,2,1,1,4,3
5514,233,7,2790.8587717308346,2,1,3,6,3
5515,329,31,343.2129296802916,1,4,1,6,3
5516,279,18,81.393352382644,2,2,1,5,3
5517,202,12,4449.24207283735,3,2,5,10,1
5518,83,48,2454.6813969064283,4,5,3,12,1
5519,125,30,2721.0153786512205,4,3,3,10,1
5520,175,33,1406.8894804350318,3,4,2,9,2
5521,69,47,2718.2961500928923,5,5,3,13,0
5522,47,7,852.6547738271665,5,1,1,7,2
5523,256,28,3730.7725289487803,2,3,4,9,2
5524,215,49,4118.512310415389,3,5,5,13,0
5525,30,3,4280.8201417971095,5,1,5,11,1
5526,281,43,542.1970599653708,2,5,1,8,2
5527,237,6,2793.1944577205163,2,1,3,6,3
5528,248,31,4045.667339521724,2,4,5,11,1
5529,25,38,649.8002761798176,5,4,1,10,1
5530,74,15,506.6168167886425,4,2,1,7,2
5531,206,7,4086.5405733634043,3,1,5,9,2
5532,314,43,3985.712834067201,1,5,4,10,1
5533,94,30,2248.978753447705,4,3,3,10,1
5534,127,27,557.4587326117235,4,3,1,8,2
5535,25,17,2585.454555011589,5,2,3,10,1
5536,334,18,1980.0679680232843,1,2,2,5,3
5537,355,22,2597.5516809096234,1,3,3,7,2
5538,116,26,2205.077058107657,4,3,3,10,1
5539,48,27,2846.8869228205367,5,3,3,11,1
5540,226,40,3638.3772953813364,2,4,4,10,1
5541,266,24,3876.550919217784,2,3,4,9,2
5542,99,8,3248.421169206842,4,1,4,9,2
5543,11,21,1002.7136690814996,5,3,1,9,2
5544,85,29,1991.6438977695445,4,3,2,9,2
5545,214,43,365.407903391251,3,5,1,9,2
5546,173,21,2263.8519030951056,3,3,3,9,2
5547,209,3,4851.993669497007,3,1,5,9,2
5548,64,31,3212.2362308791435,5,4,4,13,0
5549,258,27,781.5164481708496,2,3,1,6,3
5550,332,46,1350.2025222794086,1,5,2,8,2
5551,121,27,332.2224950497086,4,3,1,8,2
5552,298,9,920.2453118583102,1,1,1,3,3
5553,54,33,2444.3298009541113,5,4,3,12,1
5554,331,33,1730.8333433288774,1,4,2,7,2
5555,272,26,1027.7719633707457,2,3,2,7,2
5556,241,28,741.5260836786518,2,3,1,6,3
5557,243,44,3283.794873716258,2,5,4,11,1
5558,18,43,2794.930860595527,5,5,3,13,0
5559,187,31,4214.775157952191,3,4,5,12,1
5560,346,1,924.4318997814897,1,1,1,3,3
5561,144,20,4241.447445041948,4,2,5,11,1
5562,262,12,2893.776751073682,2,2,3,7,2
5563,364,17,1338.453737958781,1,2,2,5,3
5564,239,15,1375.030171436871,2,2,2,6,3
5565,304,34,1957.9981468178235,1,4,2,7,2
5566,298,16,2306.0348111673034,1,2,3,6,3
5567,76,4,421.70037283704454,4,1,1,6,3
5568,188,8,4211.575836674976,3,1,5,9,2
5569,333,34,616.4899359277284,1,4,1,6,3
5570,246,46,2422.4646167191095,2,5,3,10,1
5571,130,25,1921.0114836226996,4,3,2,9,2
5572,315,15,2566.3125507165946,1,2,3,6,3
5573,283,28,4438.537760170178,2,3,5,10,1
5574,79,9,4945.55081588197,4,1,5,10,1
5575,72,2,111.15414968696422,5,1,1,7,2
5576,263,17,1972.264764308719,2,2,2,6,3
5577,191,10,4089.8765492770453,3,1,5,9,2
5578,63,9,1639.7483725072655,5,1,2,8,2
5579,12,31,3248.690517833423,5,4,4,13,0
5580,141,2,4961.373426794637,4,1,5,10,1
5581,254,24,3237.3887311915596,2,3,4,9,2
5582,43,19,564.8449743401119,5,2,1,8,2
5583,17,17,4216.230465200388,5,2,5,12,1
5584,63,43,4833.620612089723,5,5,5,15,0
5585,253,49,3565.4170222813495,2,5,4,11,1
5586,292,10,2101.1498182169207,1,1,3,5,3
5587,8,28,4742.516874973668,5,3,5,13,0
5588,325,38,4843.1743550955,1,4,5,10,1
5589,90,48,4676.232550060796,4,5,5,14,0
5590,208,28,2064.9768215273025,3,3,3,9,2
5591,292,1,3950.641293104546,1,1,4,6,3
5592,284,3,3274.355001579959,2,1,4,7,2
5593,118,15,906.7362627690782,4,2,1,7,2
5594,349,10,2682.2193593689985,1,1,3,5,3
5595,175,21,3740.9781355518985,3,3,4,10,1
5596,76,37,4480.602257066894,4,4,5,13,0
5597,101,15,4314.365868328702,4,2,5,11,1
5598,151,23,781.7459159255557,3,3,1,7,2
5599,270,14,2445.285899961202,2,2,3,7,2
5600,71,15,2396.560461009317,5,2,3,10,1
5601,180,10,4494.697938870632,3,1,5,9,2
5602,124,9,19.667172592965578,4,1,1,6,3
5603,293,44,3696.180552758369,1,5,4,10,1
5604,285,39,3097.021167565864,2,4,4,10,1
5605,195,5,4608.641651151065,3,1,5,9,2
5606,228,25,2290.0175781553726,2,3,3,8,2
5607,275,42,3291.7845268787482,2,5,4,11,1
5608,106,26,4864.007681803496,4,3,5,12,1
5609,21,8,3722.0797769503847,5,1,4,10,1
5610,64,22,346.2460309075392,5,3,1,9,2
5611,165,25,845.9924193536459,3,3,1,7,2
5612,27,48,4109.041003769143,5,5,5,15,0
5613,311,12,1680.629749458558,1,2,2,5,3
5614,285,9,3532.5313718853918,2,1,4,7,2
5615,148,10,3502.1204293857018,3,1,4,8,2
5616,281,48,4968.565611707142,2,5,5,12,1
5617,326,10,2354.6648909453406,1,1,3,5,3
5618,319,9,3691.7834789245567,1,1,4,6,3
5619,164,26,253.27685765765065,3,3,1,7,2
5620,224,35,2318.329193258512,2,4,3,9,2
5621,272,27,941.5409086374834,2,3,1,6,3
5622,146,31,4204.452043048753,4,4,5,13,0
5623,356,19,4201.142576760194,1,2,5,8,2
5624,30,43,1189.4584593214195,5,5,2,12,1
5625,45,38,1598.2429140511763,5,4,2,11,1
5626,275,6,3515.364144457157,2,1,4,7,2
5627,34,15,3693.9469578272124,5,2,4,11,1
5628,141,29,3291.581694550725,4,3,4,11,1
5629,318,47,4983.506241255544,1,5,5,11,1
5630,221,45,4344.729227805709,2,5,5,12,1
5631,356,5,2091.1238149550873,1,1,3,5,3
5632,22,14,1641.6138404939993,5,2,2,9,2
5633,180,2,2988.2802425004415,3,1,3,7,2
5634,329,23,4090.005315809184,1,3,5,9,2
5635,231,44,2381.963933945399,2,5,3,10,1
5636,38,46,3691.0861080898812,5,5,4,14,0
5637,70,19,105.60859713515154,5,2,1,8,2
5638,116,24,4629.94214040754,4,3,5,12,1
5639,239,20,3871.4352903021077,2,2,4,8,2
5640,335,47,1977.0085329530232,1,5,2,8,2
5641,148,27,1926.2215043412675,3,3,2,8,2
5642,9,24,523.4051706650416,5,3,1,9,2
5643,288,17,4082.6070821738167,2,2,5,9,2
5644,50,25,3845.46125119335,5,3,4,12,1
5645,338,46,3154.946040602725,1,5,4,10,1
5646,5,31,516.2677959987323,5,4,1,10,1
5647,343,28,1319.0834145289832,1,3,2,6,3
5648,126,28,2299.9832215904453,4,3,3,10,1
5649,75,22,1337.1999993834875,4,3,2,9,2
5650,165,5,2175.529876532989,3,1,3,7,2
5651,278,44,1137.528127781885,2,5,2,9,2
5652,324,42,1754.5065139920234,1,5,2,8,2
5653,300,8,3264.961449147172,1,1,4,6,3
5654,290,38,4462.881793090679,2,4,5,11,1
5655,77,28,1931.303099351798,4,3,2,9,2
5656,298,47,3462.62207349218,1,5,4,10,1
5657,137,12,682.6175010487763,4,2,1,7,2
5658,106,25,2708.68170950025,4,3,3,10,1
5659,95,38,4609.304085517023,4,4,5,13,0
5660,135,44,149.39966424234325,4,5,1,10,1
5661,68,15,1345.1112350167746,5,2,2,9,2
5662,147,44,671.1427330639199,3,5,1,9,2
5663,159,41,2670.2761826871097,3,5,3,11,1
5664,163,34,3401.4158957159134,3,4,4,11,1
5665,341,45,298.3181683949156,1,5,1,7,2
5666,189,13,360.71925899635096,3,2,1,6,3
5667,339,8,4349.449671817038,1,1,5,7,2
5668,95,13,2286.6034113518663,4,2,3,9,2
5669,181,36,2320.128482196853,3,4,3,10,1
5670,288,6,4723.456170841003,2,1,5,8,2
5671,322,38,1607.8459552220095,1,4,2,7,2
5672,187,32,4486.147998693624,3,4,5,12,1
5673,138,21,4871.531175435555,4,3,5,12,1
5674,130,44,1216.0540462756474,4,5,2,11,1
5675,194,44,2575.053857570589,3,5,3,11,1
5676,316,49,2676.4372029722895,1,5,3,9,2
5677,273,7,4332.178877842399,2,1,5,8,2
5678,352,26,1526.5016005452896,1,3,2,6,3
5679,144,15,3992.23179233354,4,2,4,10,1
5680,16,49,4855.326882477279,5,5,5,15,0
5681,302,42,4203.279897194053,1,5,5,11,1
5682,245,23,4546.61001444902,2,3,5,10,1
5683,107,38,3544.688651323418,4,4,4,12,1
5684,88,41,4520.739243783097,4,5,5,14,0
5685,129,15,832.6046704081135,4,2,1,7,2
5686,341,48,3564.6834610577134,1,5,4,10,1
5687,4,40,3662.068001307666,5,4,4,13,0
5688,327,16,2201.512923032109,1,2,3,6,3
5689,306,32,407.8949521159815,1,4,1,6,3
5690,95,37,3115.994293841528,4,4,4,12,1
5691,209,18,268.88522478669853,3,2,1,6,3
5692,225,20,1918.188455821182,2,2,2,6,3
5693,348,46,1974.4144425890008,1,5,2,8,2
5694,321,2,4994.623317232031,1,1,5,7,2
5695,47,23,1506.0121483082614,5,3,2,10,1
5696,181,30,4104.065150239207,3,3,5,11,1
5697,106,3,275.32670923958545,4,1,1,6,3
5698,199,46,2653.5322670753435,3,5,3,11,1
5699,106,39,2688.0914759945003,4,4,3,11,1
5700,280,47,3147.461767440367,2,5,4,11,1
5701,260,49,4051.925964915792,2,5,5,12,1
5702,108,1,3811.9976747985083,4,1,4,9,2
5703,19,41,3807.4305603785488,5,5,4,14,0
5704,296,22,2167.1467322781914,1,3,3,7,2
5705,306,29,3640.0826975079667,1,3,4,8,2
5706,171,14,2461.665431568116,3,2,3,8,2
5707,331,48,344.08637994156095,1,5,1,7,2
5708,195,28,4452.007095232518,3,3,5,11,1
5709,12,21,4451.914897632414,5,3,5,13,0
5710,195,45,1621.1650356291452,3,5,2,10,1
5711,283,32,4570.374070211891,2,4,5,11,1
5712,182,6,3792.3403521403566,3,1,4,8,2
5713,305,1,2009.9981420014954,1,1,3,5,3
5714,144,21,1664.212936142015,4,3,2,9,2
5715,316,4,4875.962069936644,1,1,5,7,2
5716,182,3,3566.0085459254415,3,1,4,8,2
5717,30,49,1900.2616743082888,5,5,2,12,1
5718,84,30,3213.4996010242176,4,3,4,11,1
5719,166,31,2861.9157331964707,3,4,3,10,1
5720,284,34,2627.454713292764,2,4,3,9,2
5721,281,19,3227.062475071101,2,2,4,8,2
5722,96,20,2692.755347680006,4,2,3,9,2
5723,266,23,3277.403864895039,2,3,4,9,2
5724,298,40,4538.767125495959,1,4,5,10,1
5725,296,25,4966.392191044906,1,3,5,9,2
5726,225,15,3549.3414980065863,2,2,4,8,2
5727,333,38,4639.825800734659,1,4,5,10,1
5728,361,23,4293.467166875941,1,3,5,9,2
5729,42,2,1482.236615926583,5,1,2,8,2
5730,303,15,4665.210835384748,1,2,5,8,2
5731,246,44,363.33691026258117,2,5,1,8,2
5732,208,35,1656.3098870072888,3,4,2,9,2
5733,237,10,3203.325226172952,2,1,4,7,2
5734,22,14,2639.3080750167587,5,2,3,10,1
5735,185,27,2716.637840218519,3,3,3,9,2
5736,242,14,3976.4927657082276,2,2,4,8,2
5737,363,35,981.5713746080995,1,4,1,6,3
5738,283,33,4910.5567947376185,2,4,5,11,1
5739,41,1,2192.9165542128812,5,1,3,9,2
5740,336,34,4749.71789137992,1,4,5,10,1
5741,162,19,1921.748163839195,3,2,2,7,2
5742,160,24,3012.915477569662,3,3,3,9,2
5743,89,42,2257.054241902449,4,5,3,12,1
5744,322,4,3382.916467621332,1,1,4,6,3
5745,12,36,926.2873996270906,5,4,1,10,1
5746,73,13,2009.1363788740198,5,2,2,9,2
5747,76,32,351.22179931608275,4,4,1,9,2
5748,346,9,2994.5260707801676,1,1,3,5,3
5749,201,39,4813.781675959723,3,4,5,12,1
5750,10,16,239.0735106353549,5,2,1,8,2
5751,352,3,3301.553822262817,1,1,4,6,3
5752,226,20,3877.738838551922,2,2,4,8,2
5753,176,10,1073.411036646368,3,1,2,6,3
5754,276,22,1372.6407239090497,2,3,2,7,2
5755,39,48,1015.8896203377764,5,5,1,11,1
5756,60,3,1494.0890570147742,5,1,2,8,2
5757,66,11,559.3119703749371,5,2,1,8,2
5758,321,25,1858.0358777142576,1,3,2,6,3
5759,124,42,1850.9566846188302,4,5,2,11,1
5760,164,48,4038.2646084609905,3,5,5,13,0
5761,159,8,4006.781994847585,3,1,4,8,2
5762,57,9,3985.6495829137302,5,1,4,10,1
5763,78,15,2839.5092069624625,4,2,3,9,2
5764,194,32,1636.1446274630093,3,4,2,9,2
5765,285,3,2060.7129368381643,2,1,3,6,3
5766,15,4,1595.5400887627882,5,1,2,8,2
5767,12,30,2913.8202458537994,5,3,3,11,1
5768,101,13,4690.515815355195,4,2,5,11,1
5769,156,44,1429.638952438014,3,5,2,10,1
5770,340,21,2299.670570054187,1,3,3,7,2
5771,125,41,3279.0334813953073,4,5,4,13,0
5772,359,46,4225.027609859958,1,5,5,11,1
5773,280,19,1274.1362639984145,2,2,2,6,3
5774,110,39,1408.6468553921488,4,4,2,10,1
5775,334,48,4426.976005957122,1,5,5,11,1
5776,357,22,410.48801872915703,1,3,1,5,3
5777,146,20,3031.183553776391,4,2,3,9,2
5778,216,37,4303.6725263189755,3,4,5,12,1
5779,162,31,4609.496324254151,3,4,5,12,1
5780,128,10,73.30939862201512,4,1,1,6,3
5781,314,18,1854.6332276959795,1,2,2,5,3
5782,332,43,1293.7512827440228,1,5,2,8,2
5783,150,39,2844.4826179858687,3,4,3,10,1
5784,36,46,3167.98276130001,5,5,4,14,0
5785,173,20,4998.874643251588,3,2,5,10,1
5786,22,18,2568.684859525639,5,2,3,10,1
5787,206,11,2761.819724898976,3,2,3,8,2
5788,127,22,2077.424403950153,4,3,3,10,1
5789,336,44,746.9094168144926,1,5,1,7,2
5790,356,18,1523.5899550001864,1,2,2,5,3
5791,217,34,1242.4547393780488,3,4,2,9,2
5792,96,23,4008.086259828227,4,3,4,11,1
5793,164,1,2733.623943546039,3,1,3,7,2
5794,148,10,1488.0062147745568,3,1,2,6,3
5795,18,1,2450.573585438581,5,1,3,9,2
5796,294,38,1102.1357666461233,1,4,2,7,2
5797,195,39,933.7844813603575,3,4,1,8,2
5798,151,49,4301.111763837011,3,5,5,13,0
5799,123,9,4724.606163786033,4,1,5,10,1
5800,187,31,409.27289305666955,3,4,1,8,2
5801,149,7,3826.7647088602384,3,1,4,8,2
5802,104,17,2272.024566772178,4,2,3,9,2
5803,243,35,1950.9684901281842,2,4,2,8,2
5804,231,48,3450.162434643627,2,5,4,11,1
5805,206,37,1338.6058898184847,3,4,2,9,2
5806,198,18,112.70031915510104,3,2,1,6,3
5807,337,33,1077.874210621875,1,4,2,7,2
5808,87,4,932.7761327787529,4,1,1,6,3
5809,142,23,179.90641395227698,4,3,1,8,2
5810,317,11,1613.3639259713432,1,2,2,5,3
5811,199,9,2377.847482235558,3,1,3,7,2
5812,46,30,3681.7851982823863,5,3,4,12,1
5813,288,8,1635.0500142080582,2,1,2,5,3
5814,15,40,980.7559256321396,5,4,1,10,1
5815,44,5,1160.7926485754908,5,1,2,8,2
5816,169,12,4456.973625016955,3,2,5,10,1
5817,310,1,1031.5548280226703,1,1,2,4,3
5818,44,15,4397.4109309073865,5,2,5,12,1
5819,98,25,2241.023987484099,4,3,3,10,1
5820,261,18,4672.658157419147,2,2,5,9,2
5821,109,38,2046.3797601604463,4,4,3,11,1
5822,283,42,896.6378396910286,2,5,1,8,2
5823,343,46,2749.659346764575,1,5,3,9,2
5824,104,26,2942.655948216848,4,3,3,10,1
5825,256,40,3181.0916233336156,2,4,4,10,1
5826,206,3,2063.3686251629406,3,1,3,7,2
5827,335,22,252.52069056453098,1,3,1,5,3
5828,43,26,3137.332415518065,5,3,4,12,1
5829,353,19,4665.820469792189,1,2,5,8,2
5830,245,44,4788.217556243594,2,5,5,12,1
5831,287,44,2988.457985626463,2,5,3,10,1
5832,355,47,109.23621959261477,1,5,1,7,2
5833,273,39,539.1320194355733,2,4,1,7,2
5834,83,36,4171.612723589519,4,4,5,13,0
5835,110,21,4150.4247438901775,4,3,5,12,1
5836,190,41,4730.617870289127,3,5,5,13,0
5837,288,48,2823.2343701053974,2,5,3,10,1
5838,251,26,4320.443309397511,2,3,5,10,1
5839,212,13,4126.185759152568,3,2,5,10,1
5840,291,36,2951.2098229734297,2,4,3,9,2
5841,133,24,3920.3513913015977,4,3,4,11,1
5842,201,41,637.2956171172325,3,5,1,9,2
5843,285,26,3199.6217568318,2,3,4,9,2
5844,326,21,4767.7202721225985,1,3,5,9,2
5845,95,18,818.1679172126447,4,2,1,7,2
5846,278,15,3722.7729821820053,2,2,4,8,2
5847,325,15,1610.7211287434893,1,2,2,5,3
5848,219,6,4087.3485793519717,2,1,5,8,2
5849,89,43,3489.0825591912812,4,5,4,13,0
5850,72,31,4631.60954545705,5,4,5,14,0
5851,247,28,3562.5577442725375,2,3,4,9,2
5852,129,8,2057.449868864679,4,1,3,8,2
5853,212,29,64.35374710672569,3,3,1,7,2
5854,343,21,3966.6553148864327,1,3,4,8,2
5855,96,17,2048.2401836104737,4,2,3,9,2
5856,75,49,3356.46413322595,4,5,4,13,0
5857,54,24,534.2817414296097,5,3,1,9,2
5858,344,36,4455.933493129299,1,4,5,10,1
5859,54,31,2183.9324090584605,5,4,3,12,1
5860,218,47,4599.261751705322,2,5,5,12,1
5861,16,34,3538.01699463451,5,4,4,13,0
5862,99,2,616.0966878692856,4,1,1,6,3
5863,20,42,2900.1911009044193,5,5,3,13,0
5864,46,3,4550.5728952295185,5,1,5,11,1
5865,193,30,4001.8530938183226,3,3,4,10,1
5866,58,8,2095.7222338054876,5,1,3,9,2
5867,111,7,4775.771342296996,4,1,5,10,1
5868,129,12,1350.1951421996187,4,2,2,8,2
5869,337,19,1881.7874395583958,1,2,2,5,3
5870,194,26,3751.073724701124,3,3,4,10,1
5871,340,28,1172.1937405054252,1,3,2,6,3
5872,326,15,2581.718605098144,1,2,3,6,3
5873,8,14,3646.65805861973,5,2,4,11,1
5874,29,48,3223.3991530503167,5,5,4,14,0
5875,112,14,785.2958714636314,4,2,1,7,2
5876,161,3,3152.0049774778945,3,1,4,8,2
5877,131,29,2867.8255387374847,4,3,3,10,1
5878,188,6,2793.645676945171,3,1,3,7,2
5879,163,49,4131.975460820859,3,5,5,13,0
5880,197,23,927.6411523998195,3,3,1,7,2
5881,364,28,3760.314275346803,1,3,4,8,2
5882,204,14,3807.0208284980586,3,2,4,9,2
5883,212,14,3616.000743508533,3,2,4,9,2
5884,109,20,2534.7818842590127,4,2,3,9,2
5885,276,13,1983.73835121131,2,2,2,6,3
5886,73,27,1979.439028763669,5,3,2,10,1
5887,167,35,3671.7054825717805,3,4,4,11,1
5888,260,45,2494.504545888528,2,5,3,10,1
5889,243,2,1698.7842839123252,2,1,2,5,3
5890,275,41,3131.093725182555,2,5,4,11,1
5891,102,45,4186.686189910054,4,5,5,14,0
5892,173,40,316.928618429726,3,4,1,8,2
5893,171,48,4860.963419279474,3,5,5,13,0
5894,141,24,492.29317851370257,4,3,1,8,2
5895,188,29,2563.573222307562,3,3,3,9,2
5896,86,3,2805.4456247486028,4,1,3,8,2
5897,52,45,699.6714197531273,5,5,1,11,1
5898,111,4,4578.81282755822,4,1,5,10,1
5899,342,2,2362.620715689545,1,1,3,5,3
5900,43,20,724.1713671573626,5,2,1,8,2
5901,211,15,3560.9458902103765,3,2,4,9,2
5902,200,49,3320.387682760623,3,5,4,12,1
5903,298,32,4814.699193209423,1,4,5,10,1
5904,346,42,2213.1664601918637,1,5,3,9,2
5905,240,1,1346.301906092149,2,1,2,5,3
5906,115,38,309.3700914133578,4,4,1,9,2
5907,26,35,3668.2764101505445,5,4,4,13,0
5908,299,7,3090.215669259808,1,1,4,6,3
5909,77,45,4863.32806615479,4,5,5,14,0
5910,137,13,3563.703249220126,4,2,4,10,1
5911,20,49,4666.475784891698,5,5,5,15,0
5912,211,1,4957.978185950106,3,1,5,9,2
5913,240,14,2147.8714097211023,2,2,3,7,2
5914,39,29,759.9721167126927,5,3,1,9,2
5915,268,3,987.2953767472858,2,1,1,4,3
5916,207,46,1598.6923633304602,3,5,2,10,1
5917,267,24,2549.3898776607016,2,3,3,8,2
5918,154,1,620.8757969878174,3,1,1,5,3
5919,42,48,1515.572180557626,5,5,2,12,1
5920,11,10,1545.8912984407477,5,1,2,8,2
5921,294,13,30.38741827391689,1,2,1,4,3
5922,98,36,1777.3020109352997,4,4,2,10,1
5923,275,9,589.5994784225104,2,1,1,4,3
5924,230,14,2154.259784515322,2,2,3,7,2
5925,220,36,990.718319644708,2,4,1,7,2
5926,65,10,4112.350056069048,5,1,5,11,1
5927,355,40,411.82151034137956,1,4,1,6,3
5928,232,23,4329.6455527768185,2,3,5,10,1
5929,328,35,2906.8278114677455,1,4,3,8,2
5930,52,7,2298.616909359804,5,1,3,9,2
5931,263,42,2753.214161300612,2,5,3,10,1
5932,267,35,1886.7845545965695,2,4,2,8,2
5933,359,2,646.783405909806,1,1,1,3,3
5934,317,15,3831.740280761062,1,2,4,7,2
5935,324,9,4640.278834581113,1,1,5,7,2
5936,154,47,4750.837439368125,3,5,5,13,0
5937,358,17,3356.850416051495,1,2,4,7,2
5938,140,39,2057.633658318169,4,4,3,11,1
5939,51,18,2397.0162117597174,5,2,3,10,1
5940,117,15,3288.258827976685,4,2,4,10,1
5941,46,18,4117.131857376656,5,2,5,12,1
5942,309,24,1879.090016339772,1,3,2,6,3
5943,88,23,4584.738311657745,4,3,5,12,1
5944,208,12,1628.1180531037583,3,2,2,7,2
5945,269,23,2658.990278882749,2,3,3,8,2
5946,89,21,4807.195382177712,4,3,5,12,1
5947,118,26,4691.612587973795,4,3,5,12,1
5948,54,8,3481.7679967434688,5,1,4,10,1
5949,116,30,1629.5553704302936,4,3,2,9,2
5950,118,34,1102.9848155881775,4,4,2,10,1
5951,260,2,409.9153431143857,2,1,1,4,3
5952,75,5,3546.1854796495327,4,1,4,9,2
5953,305,31,2522.218963070158,1,4,3,8,2
5954,7,33,2865.715592781844,5,4,3,12,1
5955,122,4,2367.236947889432,4,1,3,8,2
5956,11,6,2419.9027035314803,5,1,3,9,2
5957,348,23,2860.6553598327764,1,3,3,7,2
5958,215,45,4572.167410818428,3,5,5,13,0
5959,279,19,156.537834345558,2,2,1,5,3
5960,28,43,4010.1675300700804,5,5,4,14,0
5961,235,45,1958.676140185746,2,5,2,9,2
5962,313,8,3727.1720937421687,1,1,4,6,3
5963,26,39,4743.146382929339,5,4,5,14,0
5964,54,13,1538.3720976964123,5,2,2,9,2
5965,29,1,456.87763735155664,5,1,1,7,2
5966,353,6,1169.1691972114788,1,1,2,4,3
5967,164,7,1118.2432272516874,3,1,2,6,3
5968,270,48,3711.8285931266673,2,5,4,11,1
5969,334,27,318.67232680833564,1,3,1,5,3
5970,35,15,264.1585634801115,5,2,1,8,2
5971,286,34,3471.1068864743415,2,4,4,10,1
5972,348,23,2788.0312275313586,1,3,3,7,2
5973,273,48,2094.660048767585,2,5,3,10,1
5974,208,49,2881.088350815455,3,5,3,11,1
5975,238,24,3678.8870507835086,2,3,4,9,2
5976,93,15,526.3221498068287,4,2,1,7,2
5977,173,35,2770.8992157449034,3,4,3,10,1
5978,79,4,4123.839996242384,4,1,5,10,1
5979,110,44,1818.5215611857786,4,5,2,11,1
5980,217,37,3817.459758236969,3,4,4,11,1
5981,358,17,4228.64998734108,1,2,5,8,2
5982,106,31,4106.436667182468,4,4,5,13,0
5983,47,38,3255.2784459094473,5,4,4,13,0
5984,181,10,3589.5491467983284,3,1,4,8,2
5985,64,27,3940.4991517667568,5,3,4,12,1
5986,246,42,3671.209454393184,2,5,4,11,1
5987,244,6,2263.8840098100277,2,1,3,6,3
5988,320,6,804.0135049310582,1,1,1,3,3
5989,87,15,1555.5556934287808,4,2,2,8,2
5990,217,4,1044.1603455878703,3,1,2,6,3
5991,7,48,1813.606330081761,5,5,2,12,1
5992,278,40,2451.762090110317,2,4,3,9,2
5993,337,7,4795.642891953888,1,1,5,7,2
5994,210,49,4797.71934699642,3,5,5,13,0
5995,169,45,3850.2467193751145,3,5,4,12,1
5996,330,47,4900.900038933069,1,5,5,11,1
5997,138,26,4990.098920964051,4,3,5,12,1
5998,306,31,4427.431171515231,1,4,5,10,1
5999,230,2,406.72288019862884,2,1,1,4,3
6000,308,28,2135.960076286667,1,3,3,7,2
6001,161,42,2675.258705316457,3,5,3,11,1
6002,1,13,629.1721022220808,5,2,1,8,2
6003,236,18,4045.066829943194,2,2,5,9,2
6004,188,30,751.9302405944167,3,3,1,7,2
6005,4,11,1922.8105892109897,5,2,2,9,2
6006,132,13,353.8717778401279,4,2,1,7,2
6007,218,24,2627.719508913628,2,3,3,8,2
6008,260,29,2989.236819705073,2,3,3,8,2
6009,1,5,3678.532482301791,5,1,4,10,1
6010,71,35,1703.9128285279355,5,4,2,11,1
6011,178,19,2956.752183019873,3,2,3,8,2
6012,189,13,3673.3952249057547,3,2,4,9,2
6013,291,5,3812.55539306102,2,1,4,7,2
6014,8,44,1515.192813785685,5,5,2,12,1
6015,253,14,347.84261158884397,2,2,1,5,3
6016,292,38,197.72119298225576,1,4,1,6,3
6017,244,22,3842.6208206159927,2,3,4,9,2
6018,123,9,1933.3401967344164,4,1,2,7,2
6019,299,49,678.3738873887241,1,5,1,7,2
6020,283,40,930.5997882511483,2,4,1,7,2
6021,32,26,3833.090869267586,5,3,4,12,1
6022,334,45,2998.520983446917,1,5,3,9,2
6023,146,5,2512.0017991562186,4,1,3,8,2
6024,156,29,3118.8078522664177,3,3,4,10,1
6025,16,22,696.1227752455462,5,3,1,9,2
6026,355,49,1602.0207921216836,1,5,2,8,2
6027,47,3,1876.57695175151,5,1,2,8,2
6028,251,28,1579.3438692051461,2,3,2,7,2
6029,187,38,4323.437397553332,3,4,5,12,1
6030,31,14,2911.29151181656,5,2,3,10,1
6031,260,47,3649.3138233446293,2,5,4,11,1
6032,17,14,1191.1633884797257,5,2,2,9,2
6033,39,43,1327.7294461057945,5,5,2,12,1
6034,304,11,1134.42655555995,1,2,2,5,3
6035,39,9,3443.018092451332,5,1,4,10,1
6036,132,38,1751.7145684956868,4,4,2,10,1
6037,30,47,2031.3698206967738,5,5,3,13,0
6038,158,44,3548.5168231159164,3,5,4,12,1
6039,278,6,4859.275522397195,2,1,5,8,2
6040,203,1,817.7578155292567,3,1,1,5,3
6041,66,25,322.7545784916691,5,3,1,9,2
6042,108,16,982.2812005176299,4,2,1,7,2
6043,268,15,3677.4538179667584,2,2,4,8,2
6044,222,34,981.1901823345914,2,4,1,7,2
6045,292,17,2925.918489098183,1,2,3,6,3
6046,18,3,2955.6795171299204,5,1,3,9,2
6047,90,3,1479.1712704824345,4,1,2,7,2
6048,181,37,352.9441365843773,3,4,1,8,2
6049,255,17,2002.0105820835074,2,2,2,6,3
6050,253,49,942.0592570601127,2,5,1,8,2
6051,257,38,930.5213192299551,2,4,1,7,2
6052,346,1,2617.7184664334172,1,1,3,5,3
6053,87,7,3368.87447910779,4,1,4,9,2
6054,90,26,386.32111080997475,4,3,1,8,2
6055,237,47,2895.8237792260793,2,5,3,10,1
6056,70,39,1238.546200807819,5,4,2,11,1
6057,44,19,3369.757324488217,5,2,4,11,1
6058,200,30,4052.97702264981,3,3,5,11,1
6059,152,43,4036.9980419727603,3,5,5,13,0
6060,86,14,1855.608177621264,4,2,2,8,2
6061,19,13,2840.675672648946,5,2,3,10,1
6062,101,20,3970.5389673485274,4,2,4,10,1
6063,95,26,313.4432047875812,4,3,1,8,2
6064,254,27,3032.065437500087,2,3,3,8,2
6065,357,25,4184.244699283984,1,3,5,9,2
6066,30,9,1868.0614195286169,5,1,2,8,2
6067,249,41,2282.486488766621,2,5,3,10,1
6068,33,48,3496.653062111156,5,5,4,14,0
6069,229,12,348.7447122098369,2,2,1,5,3
6070,12,10,1934.3234424989214,5,1,2,8,2
6071,118,6,1485.5967434170063,4,1,2,7,2
6072,350,34,94.80130543978272,1,4,1,6,3
6073,155,41,987.9035795539678,3,5,1,9,2
6074,246,19,1985.4589922883579,2,2,2,6,3
6075,332,6,995.1692549188489,1,1,1,3,3
6076,247,2,3015.9676077908366,2,1,3,6,3
6077,29,15,2248.7765106081815,5,2,3,10,1
6078,161,17,207.01166091919015,3,2,1,6,3
6079,235,16,1382.4509189194596,2,2,2,6,3
6080,190,28,107.18908419227799,3,3,1,7,2
6081,117,21,1797.094547673435,4,3,2,9,2
6082,271,8,1302.9589885517094,2,1,2,5,3
6083,258,10,3444.0520430206234,2,1,4,7,2
6084,180,10,1543.960558726696,3,1,2,6,3
6085,172,10,1882.0417362759763,3,1,2,6,3
6086,274,9,3629.416319997411,2,1,4,7,2
6087,259,28,2409.779202784178,2,3,3,8,2
6088,135,24,2786.707349193241,4,3,3,10,1
6089,171,19,4208.3198520997685,3,2,5,10,1
6090,210,33,1042.3726442322682,3,4,2,9,2
6091,236,4,4946.0357873526755,2,1,5,8,2
6092,186,3,4501.524408283566,3,1,5,9,2
6093,364,42,1439.8986147192945,1,5,2,8,2
6094,95,12,4465.762703926594,4,2,5,11,1
6095,11,18,3772.2412299010994,5,2,4,11,1
6096,68,23,4654.474795091137,5,3,5,13,0
6097,210,20,3458.7645887474714,3,2,4,9,2
6098,196,6,3375.6421410909516,3,1,4,8,2
6099,98,34,27.287401396681275,4,4,1,9,2
6100,93,42,2378.3115280885313,4,5,3,12,1
6101,22,2,1009.3403448303309,5,1,1,7,2
6102,172,30,1627.1664812533465,3,3,2,8,2
6103,134,9,4894.290013641744,4,1,5,10,1
6104,25,27,436.6547695526215,5,3,1,9,2
6105,185,42,3615.207487564425,3,5,4,12,1
6106,85,34,872.9947609356574,4,4,1,9,2
6107,55,40,46.93268409,5,4,1,10,1
6108,251,24,2512.079357151023,2,3,3,8,2
6109,144,49,814.4643408108685,4,5,1,10,1
6110,351,17,4827.67661734807,1,2,5,8,2
6111,167,29,1026.4467181753878,3,3,2,8,2
6112,224,36,968.2560174339907,2,4,1,7,2
6113,220,12,170.51295405758236,2,2,1,5,3
6114,179,31,1655.7999970077674,3,4,2,9,2
6115,119,49,130.31725789570567,4,5,1,10,1
6116,265,9,2499.444309863204,2,1,3,6,3
6117,150,19,2532.99710770877,3,2,3,8,2
6118,215,46,275.6840024492899,3,5,1,9,2
6119,197,46,1207.910762167207,3,5,2,10,1
6120,42,17,4162.211360870315,5,2,5,12,1
6121,53,2,2318.0984168975788,5,1,3,9,2
6122,330,40,2178.7041075130005,1,4,3,8,2
6123,251,5,3496.896967335373,2,1,4,7,2
6124,295,39,3577.2608980114687,1,4,4,9,2
6125,271,48,3812.1933779704755,2,5,4,11,1
6126,123,16,4154.10680218011,4,2,5,11,1
6127,339,17,1168.9307255478236,1,2,2,5,3
6128,266,27,341.2392303239616,2,3,1,6,3
6129,348,7,1907.5217442804715,1,1,2,4,3
6130,29,8,4276.93857400953,5,1,5,11,1
6131,35,8,399.3630347849842,5,1,1,7,2
6132,6,23,2884.009456026721,5,3,3,11,1
6133,111,32,3508.4039162155527,4,4,4,12,1
6134,294,43,2412.221994278663,1,5,3,9,2
6135,77,47,1283.325463596974,4,5,2,11,1
6136,349,18,1638.2843142985812,1,2,2,5,3
6137,147,38,367.5439689380945,3,4,1,8,2
6138,67,12,1469.9919012200137,5,2,2,9,2
6139,8,15,231.44625773075876,5,2,1,8,2
6140,122,28,3634.3617406885032,4,3,4,11,1
6141,340,38,4490.996439773315,1,4,5,10,1
6142,175,31,3171.2305109834288,3,4,4,11,1
6143,179,9,3286.9490824366017,3,1,4,8,2
6144,85,8,2365.9902623305275,4,1,3,8,2
6145,45,46,788.6218815334893,5,5,1,11,1
6146,136,19,48.54845485431455,4,2,1,7,2
6147,343,8,1726.4402280767497,1,1,2,4,3
6148,16,34,3759.9279012810707,5,4,4,13,0
6149,333,4,4802.553580784752,1,1,5,7,2
6150,195,31,2161.1137794520764,3,4,3,10,1
6151,9,38,1833.3011515443297,5,4,2,11,1
6152,316,3,2235.332946593592,1,1,3,5,3
6153,334,35,2144.5967300629236,1,4,3,8,2
6154,333,19,3133.1403666632386,1,2,4,7,2
6155,327,43,3673.3955115194854,1,5,4,10,1
6156,15,29,3926.9405360403553,5,3,4,12,1
6157,327,10,3251.527999079392,1,1,4,6,3
6158,102,12,2194.242554348916,4,2,3,9,2
6159,226,46,4751.017740202177,2,5,5,12,1
6160,278,30,3557.9882848926186,2,3,4,9,2
6161,113,30,2139.023623822426,4,3,3,10,1
6162,1,18,2238.443067706567,5,2,3,10,1
6163,266,24,4091.724441145787,2,3,5,10,1
6164,208,32,2208.2990297349643,3,4,3,10,1
6165,110,9,2586.205377667665,4,1,3,8,2
6166,200,47,1464.845936678924,3,5,2,10,1
6167,306,24,4196.18502108764,1,3,5,9,2
6168,12,26,2616.2045467135667,5,3,3,11,1
6169,345,3,2767.1543325632447,1,1,3,5,3
6170,188,23,4404.57025953986,3,3,5,11,1
6171,154,11,4603.381166557576,3,2,5,10,1
6172,334,10,4122.727045365935,1,1,5,7,2
6173,279,36,336.19836075676886,2,4,1,7,2
6174,171,13,2223.1104178827713,3,2,3,8,2
6175,134,29,1723.2213863706029,4,3,2,9,2
6176,25,38,1075.4387588323025,5,4,2,11,1
6177,18,13,4545.679840470471,5,2,5,12,1
6178,190,26,4451.444101989374,3,3,5,11,1
6179,141,20,2331.836437583421,4,2,3,9,2
6180,43,5,681.4586448575889,5,1,1,7,2
6181,334,20,76.69444545561939,1,2,1,4,3
6182,284,14,2197.9507320184457,2,2,3,7,2
6183,146,45,209.37619138198005,4,5,1,10,1
6184,315,14,3051.684150179603,1,2,4,7,2
6185,319,8,3045.9602656915445,1,1,4,6,3
6186,92,48,4495.707845108067,4,5,5,14,0
6187,179,13,958.3451501638895,3,2,1,6,3
6188,56,24,1863.2572696435846,5,3,2,10,1
6189,155,15,4299.131490033551,3,2,5,10,1
6190,160,1,2376.739547425674,3,1,3,7,2
6191,111,22,308.0192119700017,4,3,1,8,2
6192,137,34,562.8117188616876,4,4,1,9,2
6193,232,40,4069.138312176471,2,4,5,11,1
6194,220,3,3721.0501758422797,2,1,4,7,2
6195,68,26,4380.648770662291,5,3,5,13,0
6196,302,14,603.1172178866274,1,2,1,4,3
6197,249,41,3804.479551544672,2,5,4,11,1
6198,323,8,3278.9707811413637,1,1,4,6,3
6199,6,49,1169.1432732938035,5,5,2,12,1
6200,280,16,4869.782883922499,2,2,5,9,2
6201,94,42,2856.070547564643,4,5,3,12,1
6202,269,21,4535.321097231706,2,3,5,10,1
6203,197,10,4296.874739692862,3,1,5,9,2
6204,25,25,1672.2960480078318,5,3,2,10,1
6205,148,38,2684.424741314198,3,4,3,10,1
6206,118,22,2162.5278140293117,4,3,3,10,1
6207,338,49,3548.2970755977776,1,5,4,10,1
6208,338,48,2944.3296026717044,1,5,3,9,2
6209,66,47,3926.419129855834,5,5,4,14,0
6210,301,46,68.64377539394285,1,5,1,7,2
6211,175,4,3442.0883744586467,3,1,4,8,2
6212,319,4,1602.1351245460783,1,1,2,4,3
6213,76,30,1128.8684780481956,4,3,2,9,2
6214,114,2,4008.1944181297745,4,1,4,9,2
6215,111,29,455.21384382904506,4,3,1,8,2
6216,249,43,1150.0156250447146,2,5,2,9,2
6217,203,36,1026.6343620878931,3,4,2,9,2
6218,147,21,2104.9289708479123,3,3,3,9,2
6219,35,21,1618.4605549407324,5,3,2,10,1
6220,309,48,3605.136902377254,1,5,4,10,1
6221,26,21,3499.855704201368,5,3,4,12,1
6222,238,4,1634.0997466191345,2,1,2,5,3
6223,14,1,2190.534072967518,5,1,3,9,2
6224,45,26,1047.4618390570672,5,3,2,10,1
6225,216,2,3357.4661534763904,3,1,4,8,2
6226,233,9,1987.151473261552,2,1,2,5,3
6227,193,45,672.8022611666545,3,5,1,9,2
6228,51,18,645.0548046384412,5,2,1,8,2
6229,214,48,1618.3801853216657,3,5,2,10,1
6230,151,48,3739.151892894617,3,5,4,12,1
6231,275,42,137.2666372961869,2,5,1,8,2
6232,338,41,1296.295718982582,1,5,2,8,2
6233,76,11,820.8059328548989,4,2,1,7,2
6234,220,25,4782.824328315019,2,3,5,10,1
6235,348,26,3529.3552038154216,1,3,4,8,2
6236,187,36,1173.8310937535414,3,4,2,9,2
6237,289,42,1045.2283213266112,2,5,2,9,2
6238,28,35,4291.57242148251,5,4,5,14,0
6239,180,38,959.2312151179013,3,4,1,8,2
6240,253,3,4985.325408984162,2,1,5,8,2
6241,126,41,1418.6925688568845,4,5,2,11,1
6242,177,35,430.82024719897953,3,4,1,8,2
6243,37,40,3457.800051144122,5,4,4,13,0
6244,99,22,3052.117534995027,4,3,4,11,1
6245,98,8,4999.112605153669,4,1,5,10,1
6246,127,15,4012.407864416156,4,2,4,10,1
6247,168,45,2149.894300334863,3,5,3,11,1
6248,80,7,3386.2911263337874,4,1,4,9,2
6249,294,19,4091.0687734807266,1,2,5,8,2
6250,333,40,2573.495361962043,1,4,3,8,2
6251,126,42,1371.6285391687059,4,5,2,11,1
6252,343,17,1058.4271550089845,1,2,2,5,3
6253,310,1,1483.454368701936,1,1,2,4,3
6254,150,45,4241.863220532327,3,5,5,13,0
6255,16,29,1908.357538718789,5,3,2,10,1
6256,28,13,1440.454151245924,5,2,2,9,2
6257,173,48,4031.3772666974546,3,5,5,13,0
6258,46,29,169.2825054549721,5,3,1,9,2
6259,328,41,2973.851771942407,1,5,3,9,2
6260,236,42,4369.422697899496,2,5,5,12,1
6261,214,6,2056.317907787481,3,1,3,7,2
6262,85,5,1353.8976251828294,4,1,2,7,2
6263,282,34,2463.6282564854223,2,4,3,9,2
6264,232,11,3590.211066783476,2,2,4,8,2
6265,85,9,2587.8617595456453,4,1,3,8,2
6266,65,38,48.11858318260782,5,4,1,10,1
6267,134,40,400.83953497899944,4,4,1,9,2
6268,151,41,3609.42883121761,3,5,4,12,1
6269,115,9,2005.757161028738,4,1,2,7,2
6270,64,8,3926.031398038473,5,1,4,10,1
6271,343,44,3250.9546713884856,1,5,4,10,1
6272,363,40,2911.7640132661754,1,4,3,8,2
6273,352,3,4507.862090208272,1,1,5,7,2
6274,158,13,116.39714666875632,3,2,1,6,3
6275,77,19,783.6214633750304,4,2,1,7,2
6276,146,34,3125.6360179049593,4,4,4,12,1
6277,343,32,338.4819522849763,1,4,1,6,3
6278,225,49,3228.4027204528497,2,5,4,11,1
6279,313,16,4920.764174356086,1,2,5,8,2
6280,103,36,4395.252413982724,4,4,5,13,0
6281,347,18,2958.675450886888,1,2,3,6,3
6282,301,14,4470.943604786751,1,2,5,8,2
6283,88,30,590.1780748186634,4,3,1,8,2
6284,303,2,2278.923882978565,1,1,3,5,3
6285,168,13,2149.0938179022583,3,2,3,8,2
6286,170,27,1688.8734590950253,3,3,2,8,2
6287,135,17,11.004976690208974,4,2,1,7,2
6288,50,31,4456.234802870148,5,4,5,14,0
6289,340,15,3890.7559846624467,1,2,4,7,2
6290,347,20,3267.759002842946,1,2,4,7,2
6291,134,5,653.5445508196539,4,1,1,6,3
6292,347,7,1897.2436171206054,1,1,2,4,3
6293,137,18,4622.391716865478,4,2,5,11,1
6294,245,11,3088.4787292970377,2,2,4,8,2
6295,109,32,3021.018577264865,4,4,3,11,1
6296,313,27,4566.501608037603,1,3,5,9,2
6297,287,26,2803.570287249192,2,3,3,8,2
6298,21,37,2992.1400102993266,5,4,3,12,1
6299,90,45,1735.1213154363243,4,5,2,11,1
6300,296,28,1863.4902368695343,1,3,2,6,3
6301,112,2,3431.1782434466213,4,1,4,9,2
6302,301,20,1608.971730990247,1,2,2,5,3
6303,77,4,2799.948523733372,4,1,3,8,2
6304,177,13,1403.1914888713325,3,2,2,7,2
6305,343,24,838.9649373926823,1,3,1,5,3
6306,148,48,2277.46827010412,3,5,3,11,1
6307,101,38,1095.055601946395,4,4,2,10,1
6308,246,40,4493.486582356889,2,4,5,11,1
6309,117,48,1525.0286994768942,4,5,2,11,1
6310,92,45,2991.0364567412125,4,5,3,12,1
6311,28,29,1324.5747843205675,5,3,2,10,1
6312,25,36,1297.5161209965847,5,4,2,11,1
6313,58,2,1759.6740465772552,5,1,2,8,2
6314,297,41,4580.214090931536,1,5,5,11,1
6315,134,18,1963.57371404348,4,2,2,8,2
6316,331,49,4108.119682426481,1,5,5,11,1
6317,249,8,994.5173919467804,2,1,1,4,3
6318,38,15,250.36602025079105,5,2,1,8,2
6319,75,41,3910.5728272941933,4,5,4,13,0
6320,142,17,2713.955738310936,4,2,3,9,2
6321,322,23,2523.591807004338,1,3,3,7,2
6322,168,2,1368.3071877545738,3,1,2,6,3
6323,259,6,370.8619041481656,2,1,1,4,3
6324,355,29,2419.4715813009016,1,3,3,7,2
6325,225,27,4337.459530408865,2,3,5,10,1
6326,152,37,608.9098483803945,3,4,1,8,2
6327,19,49,4646.56268794239,5,5,5,15,0
6328,146,34,1380.8981104056572,4,4,2,10,1
6329,241,18,2665.6096012150247,2,2,3,7,2
6330,344,42,341.8768933782433,1,5,1,7,2
6331,237,10,2130.982503075202,2,1,3,6,3
6332,35,38,638.2304531717458,5,4,1,10,1
6333,190,44,249.38919252526534,3,5,1,9,2
6334,1,17,4833.122890203972,5,2,5,12,1
6335,153,13,3653.1717319660215,3,2,4,9,2
6336,126,48,3598.098027858167,4,5,4,13,0
6337,345,42,461.84295052392287,1,5,1,7,2
6338,226,27,4647.459117193832,2,3,5,10,1
6339,221,2,2352.647889899329,2,1,3,6,3
6340,211,34,4262.897499606581,3,4,5,12,1
6341,25,31,72.87949455771616,5,4,1,10,1
6342,16,23,1498.0503418741596,5,3,2,10,1
6343,182,7,4980.275139411064,3,1,5,9,2
6344,329,38,2144.911833050042,1,4,3,8,2
6345,129,33,4443.58275893313,4,4,5,13,0
6346,42,12,1646.711758371488,5,2,2,9,2
6347,336,45,2631.3923700183495,1,5,3,9,2
6348,236,12,4272.553138970543,2,2,5,9,2
6349,360,19,3033.0445954176375,1,2,3,6,3
6350,34,9,3628.709789797111,5,1,4,10,1
6351,345,10,1151.8776890556248,1,1,2,4,3
6352,45,17,787.8932829011457,5,2,1,8,2
6353,134,40,1159.2291526141835,4,4,2,10,1
6354,21,39,2470.3127449724134,5,4,3,12,1
6355,122,41,4006.8141761914135,4,5,4,13,0
6356,70,10,1776.4293138765688,5,1,2,8,2
6357,352,12,2828.430752139936,1,2,3,6,3
6358,361,15,4026.014180281407,1,2,5,8,2
6359,48,31,1201.4945658022832,5,4,2,11,1
6360,39,15,4416.048917249849,5,2,5,12,1
6361,287,28,4765.8807379896925,2,3,5,10,1
6362,10,4,204.4609776386149,5,1,1,7,2
6363,30,36,304.96443932308813,5,4,1,10,1
6364,244,1,463.8889965436223,2,1,1,4,3
6365,274,44,3886.074358463127,2,5,4,11,1
6366,88,34,954.7913564430987,4,4,1,9,2
6367,244,47,3631.222972464876,2,5,4,11,1
6368,329,17,2211.967588660713,1,2,3,6,3
6369,15,39,4182.912496763299,5,4,5,14,0
6370,4,38,4044.6915098932636,5,4,5,14,0
6371,191,44,4798.71618129841,3,5,5,13,0
6372,168,33,1262.678873877291,3,4,2,9,2
6373,9,21,1153.9034222324406,5,3,2,10,1
6374,109,26,167.2247966901104,4,3,1,8,2
6375,137,46,2057.9763161783794,4,5,3,12,1
6376,154,36,2300.7252120895314,3,4,3,10,1
6377,209,5,4822.924028812896,3,1,5,9,2
6378,272,33,4155.618617918146,2,4,5,11,1
6379,143,1,842.2906730691185,4,1,1,6,3
6380,99,6,3994.461919414922,4,1,4,9,2
6381,308,37,899.7134113704217,1,4,1,6,3
6382,69,2,398.0476985903077,5,1,1,7,2
6383,247,5,4187.042929769115,2,1,5,8,2
6384,261,26,4880.0383134660715,2,3,5,10,1
6385,276,41,449.71153719374246,2,5,1,8,2
6386,79,47,4071.4851323302255,4,5,5,14,0
6387,146,13,4297.471116729405,4,2,5,11,1
6388,111,12,602.5903654895465,4,2,1,7,2
6389,258,5,1423.4348241420107,2,1,2,5,3
6390,93,2,3670.9665886751936,4,1,4,9,2
6391,13,4,4040.574095116817,5,1,5,11,1
6392,260,27,1776.330869027829,2,3,2,7,2
6393,109,10,808.0477044008094,4,1,1,6,3
6394,330,13,3245.2389352860973,1,2,4,7,2
6395,189,44,3512.823330184956,3,5,4,12,1
6396,95,2,2523.003190936189,4,1,3,8,2
6397,105,26,733.2559275236778,4,3,1,8,2
6398,8,15,4223.988854169834,5,2,5,12,1
6399,67,46,3229.8771357419178,5,5,4,14,0
6400,191,10,4347.129601665868,3,1,5,9,2
6401,256,22,4665.515681705512,2,3,5,10,1
6402,9,40,4030.4322986359634,5,4,5,14,0
6403,117,25,4793.70049843651,4,3,5,12,1
6404,267,15,4771.74615127186,2,2,5,9,2
6405,99,13,3100.529331397777,4,2,4,10,1
6406,298,8,3643.5887684585728,1,1,4,6,3
6407,164,21,3500.048591181274,3,3,4,10,1
6408,141,21,3109.469613160562,4,3,4,11,1
6409,268,22,106.58232739595259,2,3,1,6,3
6410,37,46,1785.9743436073243,5,5,2,12,1
6411,74,33,509.39078542028693,4,4,1,9,2
6412,73,45,1508.2929595595665,5,5,2,12,1
6413,308,27,352.1383865612263,1,3,1,5,3
6414,199,40,4600.957168290145,3,4,5,12,1
6415,130,22,2262.1362791232036,4,3,3,10,1
6416,246,30,954.9285939001732,2,3,1,6,3
6417,312,9,2928.04836300912,1,1,3,5,3
6418,60,45,990.2901575293743,5,5,1,11,1
6419,279,35,4024.157205734227,2,4,5,11,1
6420,103,18,1536.5363576038528,4,2,2,8,2
6421,296,42,1581.3541579960045,1,5,2,8,2
6422,320,5,4351.055210142931,1,1,5,7,2
6423,341,27,2800.4223944046716,1,3,3,7,2
6424,151,6,4437.637507719995,3,1,5,9,2
6425,157,32,2070.311269028137,3,4,3,10,1
6426,206,8,1726.1992057948687,3,1,2,6,3
6427,179,39,2535.95295635788,3,4,3,10,1
6428,197,21,316.8434393025186,3,3,1,7,2
6429,223,18,779.4618483345128,2,2,1,5,3
6430,89,14,1105.4129622743235,4,2,2,8,2
6431,287,15,4085.219640605445,2,2,5,9,2
6432,276,42,3671.6557969846963,2,5,4,11,1
6433,236,26,974.6033211318786,2,3,1,6,3
6434,183,44,1390.9703462238942,3,5,2,10,1
6435,209,32,4721.8666987009665,3,4,5,12,1
6436,130,39,438.1567815078604,4,4,1,9,2
6437,153,28,2741.8009397588203,3,3,3,9,2
6438,13,39,2614.81489015235,5,4,3,12,1
6439,122,43,3631.282007616869,4,5,4,13,0
6440,359,32,1314.5625280039778,1,4,2,7,2
6441,220,13,4674.515527481546,2,2,5,9,2
6442,106,15,2058.8085793271875,4,2,3,9,2
6443,70,18,1435.7408400986824,5,2,2,9,2
6444,195,39,1690.9783900608654,3,4,2,9,2
6445,186,6,1750.1245205134248,3,1,2,6,3
6446,99,11,1002.6527841897467,4,2,1,7,2
6447,82,32,4640.9890598407255,4,4,5,13,0
6448,75,40,882.6271712005774,4,4,1,9,2
6449,340,20,4415.334845353453,1,2,5,8,2
6450,192,33,2030.5968075027329,3,4,3,10,1
6451,325,40,1353.6896527186507,1,4,2,7,2
6452,214,8,1000.55967466492,3,1,1,5,3
6453,315,35,2526.668226242268,1,4,3,8,2
6454,318,5,3349.600129517936,1,1,4,6,3
6455,144,35,4492.122941997802,4,4,5,13,0
6456,216,47,3265.7084527135708,3,5,4,12,1
6457,361,14,2423.475826461123,1,2,3,6,3
6458,324,21,177.04556224534855,1,3,1,5,3
6459,15,47,4577.980259321342,5,5,5,15,0
6460,217,24,4512.822522482375,3,3,5,11,1
6461,35,17,1899.7976669309164,5,2,2,9,2
6462,183,18,154.88296675130638,3,2,1,6,3
6463,270,34,3669.5140620229427,2,4,4,10,1
6464,358,12,3960.4875755170897,1,2,4,7,2
6465,100,16,2716.904489481182,4,2,3,9,2
6466,7,4,2020.3461764614754,5,1,3,9,2
6467,30,25,4257.152860636965,5,3,5,13,0
6468,305,34,970.6569192669164,1,4,1,6,3
6469,144,28,2203.3953641869457,4,3,3,10,1
6470,111,46,132.18569248626642,4,5,1,10,1
6471,232,11,828.412534607656,2,2,1,5,3
6472,179,13,4704.747861043274,3,2,5,10,1
6473,72,31,2894.63541932014,5,4,3,12,1
6474,210,25,4029.905724343814,3,3,5,11,1
6475,220,39,2437.63706637254,2,4,3,9,2
6476,80,10,4175.787219062616,4,1,5,10,1
6477,83,24,2699.363049098181,4,3,3,10,1
6478,42,1,32.64318992081831,5,1,1,7,2
6479,273,25,4499.498045083833,2,3,5,10,1
6480,191,28,751.3449379812039,3,3,1,7,2
6481,173,36,2258.2682589257765,3,4,3,10,1
6482,7,18,2388.6049009551357,5,2,3,10,1
6483,155,6,245.70900571167203,3,1,1,5,3
6484,10,2,274.82122334183214,5,1,1,7,2
6485,34,3,3815.133529129087,5,1,4,10,1
6486,36,46,1509.2494423529674,5,5,2,12,1
6487,6,8,2054.0445495370213,5,1,3,9,2
6488,215,31,2824.9214521715467,3,4,3,10,1
6489,134,48,1873.1966616912355,4,5,2,11,1
6490,285,19,3877.436758450538,2,2,4,8,2
6491,126,6,4423.478621559646,4,1,5,10,1
6492,337,14,307.9922417580926,1,2,1,4,3
6493,174,3,3180.6628856839975,3,1,4,8,2
6494,152,48,1595.1234372111705,3,5,2,10,1
6495,331,1,2920.543639299794,1,1,3,5,3
6496,26,44,2424.6975174801696,5,5,3,13,0
6497,115,30,1675.0558198512883,4,3,2,9,2
6498,284,46,483.13007518990577,2,5,1,8,2
6499,75,19,2801.605158399459,4,2,3,9,2
6500,166,19,572.834906469634,3,2,1,6,3
6501,189,9,789.0392400017085,3,1,1,5,3
6502,78,7,4911.054522105242,4,1,5,10,1
6503,90,46,1590.358899831923,4,5,2,11,1
6504,176,37,2926.33658621114,3,4,3,10,1
6505,21,41,1368.4373906751293,5,5,2,12,1
6506,54,7,4328.892098644673,5,1,5,11,1
6507,184,9,1423.867552458019,3,1,2,6,3
6508,359,4,1840.7569066710696,1,1,2,4,3
6509,222,25,3045.854013272065,2,3,4,9,2
6510,315,49,4351.233671146487,1,5,5,11,1
6511,328,12,4082.9086311097562,1,2,5,8,2
6512,179,6,1326.6608289292467,3,1,2,6,3
6513,276,18,4149.479237902716,2,2,5,9,2
6514,112,40,3508.964623800906,4,4,4,12,1
6515,224,21,4949.2441671509705,2,3,5,10,1
6516,214,15,4677.883863251394,3,2,5,10,1
6517,59,3,2670.3522430064327,5,1,3,9,2
6518,327,2,3752.143809770781,1,1,4,6,3
6519,109,41,2855.1967129162695,4,5,3,12,1
6520,157,40,2979.027256153712,3,4,3,10,1
6521,191,4,516.489141589116,3,1,1,5,3
6522,200,32,21.206085303499755,3,4,1,8,2
6523,312,2,250.4500086296875,1,1,1,3,3
6524,196,46,4833.487032793178,3,5,5,13,0
6525,35,29,640.078457335716,5,3,1,9,2
6526,246,2,231.50462383417846,2,1,1,4,3
6527,237,34,1555.1246064387533,2,4,2,8,2
6528,104,27,2945.017900373096,4,3,3,10,1
6529,7,39,4742.818615071635,5,4,5,14,0
6530,283,44,3502.43901697192,2,5,4,11,1
6531,1,38,1389.0013148118323,5,4,2,11,1
6532,219,18,4695.89951100337,2,2,5,9,2
6533,230,36,189.8449655733522,2,4,1,7,2
6534,172,19,4895.479496261296,3,2,5,10,1
6535,87,27,302.61709712398056,4,3,1,8,2
6536,41,45,3771.711365555258,5,5,4,14,0
6537,123,20,236.03472047553007,4,2,1,7,2
6538,331,21,4658.491597418851,1,3,5,9,2
6539,298,23,552.2428246883843,1,3,1,5,3
6540,178,30,261.8902750054041,3,3,1,7,2
6541,63,25,4447.433122576488,5,3,5,13,0
6542,165,31,488.01148074894877,3,4,1,8,2
6543,187,27,3991.677140992617,3,3,4,10,1
6544,209,34,3737.702855875479,3,4,4,11,1
6545,227,8,2998.4014120569477,2,1,3,6,3
6546,48,19,1896.0339738943396,5,2,2,9,2
6547,224,41,4578.746942668616,2,5,5,12,1
6548,3,26,4356.695466781941,5,3,5,13,0
6549,175,28,2136.9730836728995,3,3,3,9,2
6550,99,4,1166.3075320100945,4,1,2,7,2
6551,116,31,1370.1326303978883,4,4,2,10,1
6552,270,16,1109.414651039144,2,2,2,6,3
6553,253,10,2710.847294175115,2,1,3,6,3
6554,317,38,4344.008754565785,1,4,5,10,1
6555,95,48,3870.32371631887,4,5,4,13,0
6556,273,10,3979.5971951277406,2,1,4,7,2
6557,24,45,2246.9595735812304,5,5,3,13,0
6558,116,9,1618.9997106739168,4,1,2,7,2
6559,151,39,3789.205295818212,3,4,4,11,1
6560,338,36,3968.5583965138926,1,4,4,9,2
6561,50,36,3479.8149953387215,5,4,4,13,0
6562,206,19,170.2145414859195,3,2,1,6,3
6563,335,19,2952.5265934617346,1,2,3,6,3
6564,79,12,1741.7586879469443,4,2,2,8,2
6565,70,13,989.0018176425717,5,2,1,8,2
6566,27,25,3475.0323640780703,5,3,4,12,1
6567,271,36,1349.9454170735285,2,4,2,8,2
6568,50,25,4565.07738318972,5,3,5,13,0
6569,292,28,1497.4145780783424,1,3,2,6,3
6570,247,42,2780.3511922217813,2,5,3,10,1
6571,264,39,4140.533196621652,2,4,5,11,1
6572,79,30,2016.5705067566425,4,3,3,10,1
6573,190,5,4145.003216612724,3,1,5,9,2
6574,47,17,3621.2450233686254,5,2,4,11,1
6575,361,18,4605.121105884942,1,2,5,8,2
6576,354,43,1635.9144673229293,1,5,2,8,2
6577,352,47,534.09004325286,1,5,1,7,2
6578,189,21,2157.443994672833,3,3,3,9,2
6579,256,22,3931.209211253799,2,3,4,9,2
6580,222,39,2257.671215816375,2,4,3,9,2
6581,241,6,1317.3197716634224,2,1,2,5,3
6582,269,16,147.73985608934376,2,2,1,5,3
6583,1,2,1571.9887767495784,5,1,2,8,2
6584,34,1,3569.7717447040586,5,1,4,10,1
6585,79,30,746.5926435714155,4,3,1,8,2
6586,236,43,1710.988107733118,2,5,2,9,2
6587,334,37,110.95499390851015,1,4,1,6,3
6588,349,48,3611.557466097696,1,5,4,10,1
6589,98,23,4404.608404785365,4,3,5,12,1
6590,82,1,2846.9563052632907,4,1,3,8,2
6591,192,19,139.1018084042287,3,2,1,6,3
6592,253,46,1095.9503096221702,2,5,2,9,2
6593,38,3,2197.9609851216915,5,1,3,9,2
6594,14,2,2942.030290601813,5,1,3,9,2
6595,347,37,2486.418948927651,1,4,3,8,2
6596,310,17,4580.171571592245,1,2,5,8,2
6597,209,28,4693.795218843512,3,3,5,11,1
6598,357,18,544.690788070436,1,2,1,4,3
6599,89,33,700.5704822546198,4,4,1,9,2
6600,56,15,1796.6940120396662,5,2,2,9,2
6601,94,22,2111.9620606839667,4,3,3,10,1
6602,93,41,2934.4727963790165,4,5,3,12,1
6603,340,27,3868.0671514404066,1,3,4,8,2
6604,85,37,687.4808507530954,4,4,1,9,2
6605,245,32,4015.1720834269263,2,4,5,11,1
6606,22,45,3054.0412842418173,5,5,4,14,0
6607,291,19,4904.613459367058,2,2,5,9,2
6608,272,28,3259.326713631836,2,3,4,9,2
6609,306,28,3583.2966086561814,1,3,4,8,2
6610,122,10,984.0922433468259,4,1,1,6,3
6611,128,20,3846.621157241591,4,2,4,10,1
6612,113,25,405.5382266390366,4,3,1,8,2
6613,273,21,3286.0868765790483,2,3,4,9,2
6614,336,14,287.30881515501983,1,2,1,4,3
6615,130,22,584.976848334888,4,3,1,8,2
6616,132,26,548.252708839788,4,3,1,8,2
6617,85,44,271.8954834645559,4,5,1,10,1
6618,350,11,1612.4831955600228,1,2,2,5,3
6619,81,7,4971.818764933655,4,1,5,10,1
6620,325,17,1747.644588623066,1,2,2,5,3
6621,69,18,3806.2718075593634,5,2,4,11,1
6622,148,7,670.2619091269316,3,1,1,5,3
6623,16,20,2277.910490524619,5,2,3,10,1
6624,307,38,933.728019468812,1,4,1,6,3
6625,105,11,968.5648787650881,4,2,1,7,2
6626,165,44,507.4532825044495,3,5,1,9,2
6627,201,16,2165.9003236093813,3,2,3,8,2
6628,197,27,386.9192545358604,3,3,1,7,2
6629,185,11,4549.958668214748,3,2,5,10,1
6630,322,16,2245.022604644052,1,2,3,6,3
6631,265,23,4194.445045775028,2,3,5,10,1
6632,363,12,4897.527604030505,1,2,5,8,2
6633,100,40,3392.1181023129957,4,4,4,12,1
6634,342,3,4508.538678099525,1,1,5,7,2
6635,320,2,685.4839273099819,1,1,1,3,3
6636,214,38,4151.668292853555,3,4,5,12,1
6637,278,48,1363.3744927177795,2,5,2,9,2
6638,162,24,2368.2642138223828,3,3,3,9,2
6639,157,29,3236.447418980718,3,3,4,10,1
6640,251,47,4518.6825267507165,2,5,5,12,1
6641,97,46,4555.859066639412,4,5,5,14,0
6642,18,34,469.5908619378065,5,4,1,10,1
6643,327,20,1829.1318892170814,1,2,2,5,3
6644,97,18,3967.9442813542414,4,2,4,10,1
6645,1,14,3518.7528772688047,5,2,4,11,1
6646,216,18,141.49870065393176,3,2,1,6,3
6647,132,2,2254.948131234179,4,1,3,8,2
6648,260,1,4147.9729446668525,2,1,5,8,2
6649,125,20,3691.045342295526,4,2,4,10,1
6650,82,34,2065.13046373829,4,4,3,11,1
6651,283,41,3678.45400051031,2,5,4,11,1
6652,171,41,2760.5414385916665,3,5,3,11,1
6653,59,48,4564.01870036075,5,5,5,15,0
6654,32,11,2939.7646002587135,5,2,3,10,1
6655,161,27,2009.6635521838969,3,3,3,9,2
6656,284,23,4315.97391659549,2,3,5,10,1
6657,106,38,258.8455231101381,4,4,1,9,2
6658,105,44,4503.548111751009,4,5,5,14,0
6659,228,3,3484.770604343949,2,1,4,7,2
6660,188,12,4703.623243516149,3,2,5,10,1
6661,70,30,1260.0192969435222,5,3,2,10,1
6662,318,31,3477.657609552908,1,4,4,9,2
6663,290,23,4049.221701860913,2,3,5,10,1
6664,87,1,3513.491873131525,4,1,4,9,2
6665,362,41,1059.5651744234326,1,5,2,8,2
6666,56,20,1385.1919446834897,5,2,2,9,2
6667,113,6,2838.044318778842,4,1,3,8,2
6668,13,11,2239.2855074269396,5,2,3,10,1
6669,18,35,3678.2347701984763,5,4,4,13,0
6670,182,4,1899.596690416939,3,1,2,6,3
6671,113,29,4298.807804080016,4,3,5,12,1
6672,229,10,2165.2828211333835,2,1,3,6,3
6673,171,29,209.8059907668141,3,3,1,7,2
6674,295,38,96.64673866587907,1,4,1,6,3
6675,189,1,3237.245504561893,3,1,4,8,2
6676,79,40,2707.360060226311,4,4,3,11,1
6677,146,8,2718.2957703478805,4,1,3,8,2
6678,182,38,3952.144989981943,3,4,4,11,1
6679,286,17,1884.8439708522008,2,2,2,6,3
6680,250,19,4977.280517998974,2,2,5,9,2
6681,354,33,4728.195202043163,1,4,5,10,1
6682,314,15,74.6792181175453,1,2,1,4,3
6683,196,45,4479.756413311793,3,5,5,13,0
6684,323,31,3405.942755346835,1,4,4,9,2
6685,71,21,2515.430780712014,5,3,3,11,1
6686,248,3,2917.909895729272,2,1,3,6,3
6687,146,2,4210.868242688964,4,1,5,10,1
6688,106,35,4755.676586444389,4,4,5,13,0
6689,263,41,2806.064787434848,2,5,3,10,1
6690,296,16,914.6443214710637,1,2,1,4,3
6691,70,45,3202.3723792731016,5,5,4,14,0
6692,193,21,390.33265225901755,3,3,1,7,2
6693,68,12,3179.3422968059904,5,2,4,11,1
6694,305,28,4044.9728946090986,1,3,5,9,2
6695,52,12,1773.1238680645758,5,2,2,9,2
6696,363,33,365.2102770333167,1,4,1,6,3
6697,285,20,3464.208380780402,2,2,4,8,2
6698,334,40,1703.2504633412098,1,4,2,7,2
6699,9,49,1252.9922928839526,5,5,2,12,1
6700,251,21,3449.0169771267774,2,3,4,9,2
6701,332,39,4848.236479854886,1,4,5,10,1
6702,298,41,3729.1586633544302,1,5,4,10,1
6703,184,49,2461.836702391284,3,5,3,11,1
6704,179,42,3006.5485048964993,3,5,3,11,1
6705,198,36,719.9717543420863,3,4,1,8,2
6706,128,22,4067.9342955572115,4,3,5,12,1
6707,20,26,3025.43210295098,5,3,3,11,1
6708,328,7,4829.493686010106,1,1,5,7,2
6709,65,7,4897.62200776684,5,1,5,11,1
6710,182,8,1779.3875952776114,3,1,2,6,3
6711,241,26,4942.844218208228,2,3,5,10,1
6712,24,24,4784.599305231925,5,3,5,13,0
6713,83,24,3202.761499387629,4,3,4,11,1
6714,319,40,1673.9874980111897,1,4,2,7,2
6715,185,48,3769.1677015313676,3,5,4,12,1
6716,316,12,1363.4737844671179,1,2,2,5,3
6717,99,47,3152.9210444061573,4,5,4,13,0
6718,62,8,132.6622528598245,5,1,1,7,2
6719,286,9,3146.6281547554263,2,1,4,7,2
6720,22,3,4758.5253408204735,5,1,5,11,1
6721,212,21,1183.3637831040362,3,3,2,8,2
6722,126,31,3893.11563871173,4,4,4,12,1
6723,42,48,1474.1835140788519,5,5,2,12,1
6724,98,47,3542.170246155921,4,5,4,13,0
6725,31,24,3502.8621256688916,5,3,4,12,1
6726,158,4,931.8413310354878,3,1,1,5,3
6727,112,20,2989.6682730008893,4,2,3,9,2
6728,247,16,4297.253076034637,2,2,5,9,2
6729,122,10,1918.8400165034104,4,1,2,7,2
6730,273,43,3554.281987231074,2,5,4,11,1
6731,294,26,3375.405875820387,1,3,4,8,2
6732,207,29,1294.9948689850123,3,3,2,8,2
6733,110,5,4594.03136333066,4,1,5,10,1
6734,278,11,2821.9252997402023,2,2,3,7,2
6735,56,29,1782.9103574595654,5,3,2,10,1
6736,57,45,830.1482947551592,5,5,1,11,1
6737,291,15,2372.557178574647,2,2,3,7,2
6738,114,6,3653.266055129483,4,1,4,9,2
6739,308,48,3121.96494615723,1,5,4,10,1
6740,341,15,3637.9922721682888,1,2,4,7,2
6741,198,43,3960.886153978917,3,5,4,12,1
6742,321,20,2210.6137847823056,1,2,3,6,3
6743,179,34,2605.629258281219,3,4,3,10,1
6744,219,2,4932.246336788644,2,1,5,8,2
6745,277,44,4840.576465146119,2,5,5,12,1
6746,16,16,2079.937452546707,5,2,3,10,1
6747,61,19,3429.0458257904106,5,2,4,11,1
6748,54,34,1345.2749898559855,5,4,2,11,1
6749,168,49,771.9607527218856,3,5,1,9,2
6750,26,14,3844.3221008924306,5,2,4,11,1
6751,336,24,2186.5380473959412,1,3,3,7,2
6752,65,28,893.4934902135947,5,3,1,9,2
6753,100,48,3796.65113836753,4,5,4,13,0
6754,74,32,4576.700095372176,4,4,5,13,0
6755,192,37,4667.034767284107,3,4,5,12,1
6756,171,10,2985.7052052284716,3,1,3,7,2
6757,273,49,2403.409233584619,2,5,3,10,1
6758,187,45,717.9142649474098,3,5,1,9,2
6759,23,48,3966.021123237955,5,5,4,14,0
6760,181,9,4727.162528980446,3,1,5,9,2
6761,327,24,4448.40746395081,1,3,5,9,2
6762,108,36,3761.3994376439773,4,4,4,12,1
6763,335,29,32.79862432797247,1,3,1,5,3
6764,162,29,2044.6768642906302,3,3,3,9,2
6765,302,48,2059.4637167920214,1,5,3,9,2
6766,206,23,4472.897482469062,3,3,5,11,1
6767,78,27,337.5970774260512,4,3,1,8,2
6768,16,31,2660.8006935708136,5,4,3,12,1
6769,327,43,689.3106755963147,1,5,1,7,2
6770,96,7,3314.8466321872015,4,1,4,9,2
6771,147,49,3963.3548860091228,3,5,4,12,1
6772,2,45,3213.37646773844,5,5,4,14,0
6773,10,4,3974.979853692923,5,1,4,10,1
6774,125,14,3041.4065256820827,4,2,4,10,1
6775,81,42,957.2971612696335,4,5,1,10,1
6776,140,42,1919.4909573268496,4,5,2,11,1
6777,326,10,4784.775392824303,1,1,5,7,2
6778,150,44,1447.9928147622531,3,5,2,10,1
6779,288,34,323.6832974741165,2,4,1,7,2
6780,361,26,1930.3015747288075,1,3,2,6,3
6781,340,23,1837.8725230321313,1,3,2,6,3
6782,129,9,2356.8409905047647,4,1,3,8,2
6783,239,37,2805.9140761852505,2,4,3,9,2
6784,58,8,4962.192099870376,5,1,5,11,1
6785,198,14,3783.6073715082257,3,2,4,9,2
6786,211,7,189.0949136459745,3,1,1,5,3
6787,45,7,3566.434517750498,5,1,4,10,1
6788,97,9,4122.916424574674,4,1,5,10,1
6789,279,3,4479.197387033088,2,1,5,8,2
6790,23,14,2125.7904534829822,5,2,3,10,1
6791,335,17,1574.9915848481892,1,2,2,5,3
6792,44,44,4198.230715688958,5,5,5,15,0
6793,27,22,3890.3008926991088,5,3,4,12,1
6794,282,46,2684.8518253294706,2,5,3,10,1
6795,97,26,598.2350942316095,4,3,1,8,2
6796,36,28,3262.2890819498243,5,3,4,12,1
6797,109,45,337.6811565000422,4,5,1,10,1
6798,55,14,510.8303554039345,5,2,1,8,2
6799,192,9,1662.3897922369051,3,1,2,6,3
6800,219,26,1862.1657293716314,2,3,2,7,2
6801,185,2,2315.2504540624977,3,1,3,7,2
6802,69,11,1702.323366501556,5,2,2,9,2
6803,317,17,178.6028956182513,1,2,1,4,3
6804,130,34,795.5042652844107,4,4,1,9,2
6805,55,19,584.4087095018513,5,2,1,8,2
6806,97,39,2161.606156844138,4,4,3,11,1
6807,336,18,1068.523346636506,1,2,2,5,3
6808,87,13,1474.7910115458842,4,2,2,8,2
6809,294,5,2363.121642189984,1,1,3,5,3
6810,119,23,1185.4536804545348,4,3,2,9,2
6811,208,24,1237.1862308864359,3,3,2,8,2
6812,334,29,4167.389445158978,1,3,5,9,2
6813,154,48,2744.9534716226412,3,5,3,11,1
6814,35,47,4285.229663384184,5,5,5,15,0
6815,79,8,2577.48431694386,4,1,3,8,2
6816,67,26,4547.228519792375,5,3,5,13,0
6817,343,15,1281.1629367500777,1,2,2,5,3
6818,34,1,3087.1834669015334,5,1,4,10,1
6819,97,28,2521.1265515308555,4,3,3,10,1
6820,169,49,4594.267724149133,3,5,5,13,0
6821,169,47,2098.2130935080822,3,5,3,11,1
6822,151,46,4275.570828200172,3,5,5,13,0
6823,71,14,2823.8812125232616,5,2,3,10,1
6824,3,42,3545.6293297838815,5,5,4,14,0
6825,314,34,4435.596534666585,1,4,5,10,1
6826,32,31,4984.563009376928,5,4,5,14,0
6827,287,6,3658.38639765212,2,1,4,7,2
6828,82,49,1579.4645450597359,4,5,2,11,1
6829,43,5,1502.0698465276273,5,1,2,8,2
6830,105,31,1552.4280862109013,4,4,2,10,1
6831,1,37,498.5625182944963,5,4,1,10,1
6832,61,15,277.4584707250581,5,2,1,8,2
6833,270,15,2908.4059528552507,2,2,3,7,2
6834,180,43,4054.836750836245,3,5,5,13,0
6835,224,5,190.31135367864735,2,1,1,4,3
6836,6,28,2837.5051391449842,5,3,3,11,1
6837,103,33,1865.087994901918,4,4,2,10,1
6838,10,11,4463.5011607625165,5,2,5,12,1
6839,71,43,735.4807751156222,5,5,1,11,1
6840,90,6,2821.525704997633,4,1,3,8,2
6841,226,23,4854.894327904015,2,3,5,10,1
6842,158,40,1731.7145026606627,3,4,2,9,2
6843,228,2,3711.4667873545927,2,1,4,7,2
6844,126,15,4413.431263650026,4,2,5,11,1
6845,209,23,939.1907067339264,3,3,1,7,2
6846,97,22,4962.7106295074,4,3,5,12,1
6847,74,9,4048.839458544761,4,1,5,10,1
6848,115,47,696.4456479815725,4,5,1,10,1
6849,191,40,1561.3146555690398,3,4,2,9,2
6850,170,30,3128.600491403145,3,3,4,10,1
6851,307,16,4425.739635395918,1,2,5,8,2
6852,204,46,982.2292577354644,3,5,1,9,2
6853,56,47,3658.7158569020203,5,5,4,14,0
6854,208,30,1360.5335859579238,3,3,2,8,2
6855,41,45,4029.0280886320465,5,5,5,15,0
6856,32,9,3420.3757161024164,5,1,4,10,1
6857,15,1,2619.3160829963504,5,1,3,9,2
6858,62,38,3252.8311524209103,5,4,4,13,0
6859,155,8,4383.461775213747,3,1,5,9,2
6860,284,18,1938.2650406339537,2,2,2,6,3
6861,209,27,3848.5583989785828,3,3,4,10,1
6862,320,18,802.9381200287273,1,2,1,4,3
6863,187,32,3508.915971555089,3,4,4,11,1
6864,130,49,3755.7802387338356,4,5,4,13,0
6865,127,32,2220.5585068047317,4,4,3,11,1
6866,292,48,3970.1743054448907,1,5,4,10,1
6867,114,45,2789.9457957306063,4,5,3,12,1
6868,199,36,4682.009244370634,3,4,5,12,1
6869,13,36,571.207515447209,5,4,1,10,1
6870,271,21,662.7989170632571,2,3,1,6,3
6871,89,46,4213.712935802331,4,5,5,14,0
6872,215,32,4213.382760086097,3,4,5,12,1
6873,278,31,2361.411508529211,2,4,3,9,2
6874,203,37,4820.171427262431,3,4,5,12,1
6875,74,16,3400.152699947249,4,2,4,10,1
6876,25,46,4914.437701342689,5,5,5,15,0
6877,101,46,2666.6530220545783,4,5,3,12,1
6878,176,14,1016.0505877975977,3,2,1,6,3
6879,117,24,2227.5217038753617,4,3,3,10,1
6880,166,25,4902.629341315602,3,3,5,11,1
6881,41,46,1858.3656256167435,5,5,2,12,1
6882,344,35,4785.512001342819,1,4,5,10,1
6883,120,17,3987.1365248948396,4,2,4,10,1
6884,97,46,2216.110575687057,4,5,3,12,1
6885,145,42,2713.936449468342,4,5,3,12,1
6886,216,45,3041.1209956386547,3,5,4,12,1
6887,229,4,3332.172762804225,2,1,4,7,2
6888,313,11,392.7290909094473,1,2,1,4,3
6889,130,47,4668.604381556904,4,5,5,14,0
6890,352,15,2989.0285683723205,1,2,3,6,3
6891,318,30,4656.43460582306,1,3,5,9,2
6892,137,24,3163.17337172894,4,3,4,11,1
6893,324,2,2160.767290158658,1,1,3,5,3
6894,337,43,2838.970777566298,1,5,3,9,2
6895,273,34,4149.221337461022,2,4,5,11,1
6896,117,23,1637.367898943852,4,3,2,9,2
6897,306,31,4782.735684808835,1,4,5,10,1
6898,94,37,2335.1164370506244,4,4,3,11,1
6899,168,13,4781.622640465958,3,2,5,10,1
6900,203,33,4404.975507568883,3,4,5,12,1
6901,341,7,3840.6331625149032,1,1,4,6,3
6902,149,32,2342.5146191916583,3,4,3,10,1
6903,183,7,2938.8562701284573,3,1,3,7,2
6904,152,42,4191.766767678025,3,5,5,13,0
6905,74,38,2724.838451304856,4,4,3,11,1
6906,274,44,3693.5659869270703,2,5,4,11,1
6907,42,13,3955.3886645237485,5,2,4,11,1
6908,212,24,2570.3452758867365,3,3,3,9,2
6909,101,28,2685.875116584807,4,3,3,10,1
6910,45,32,997.1952389371932,5,4,1,10,1
6911,82,43,1231.2484967583503,4,5,2,11,1
6912,17,18,4525.6664841391175,5,2,5,12,1
6913,73,34,4203.244767189957,5,4,5,14,0
6914,14,48,60.51156711516892,5,5,1,11,1
6915,157,34,4348.244054080431,3,4,5,12,1
6916,223,38,135.92207907814242,2,4,1,7,2
6917,132,1,2296.8192106822185,4,1,3,8,2
6918,338,43,346.48930329340436,1,5,1,7,2
6919,47,42,4844.427460901273,5,5,5,15,0
6920,107,31,4861.873086463039,4,4,5,13,0
6921,108,1,3058.2460004134196,4,1,4,9,2
6922,265,16,1967.1025050094327,2,2,2,6,3
6923,205,39,2564.843823470951,3,4,3,10,1
6924,79,15,3813.8736092047593,4,2,4,10,1
6925,155,33,1123.7328690037168,3,4,2,9,2
6926,271,23,2214.1952311724776,2,3,3,8,2
6927,247,41,3688.9707643628935,2,5,4,11,1
6928,19,34,1983.0084644072651,5,4,2,11,1
6929,346,17,169.66264524255521,1,2,1,4,3
6930,26,25,2541.8981510850476,5,3,3,11,1
6931,217,42,3689.6817010723375,3,5,4,12,1
6932,154,6,4884.313881830955,3,1,5,9,2
6933,154,31,194.86030445478008,3,4,1,8,2
6934,174,5,2704.203804733376,3,1,3,7,2
6935,92,40,2255.1939240733977,4,4,3,11,1
6936,338,40,1219.8194585617903,1,4,2,7,2
6937,181,30,3192.435973035716,3,3,4,10,1
6938,131,5,826.4762393503528,4,1,1,6,3
6939,298,12,1426.4851889011154,1,2,2,5,3
6940,275,7,3910.9693769738706,2,1,4,7,2
6941,273,45,2307.454582727519,2,5,3,10,1
6942,76,13,4968.416528130225,4,2,5,11,1
6943,177,49,1938.4391133024824,3,5,2,10,1
6944,184,4,2321.6727198400795,3,1,3,7,2
6945,319,42,1508.286232821785,1,5,2,8,2
6946,131,3,1189.1050948933168,4,1,2,7,2
6947,363,12,4612.184241862137,1,2,5,8,2
6948,49,1,3746.644934242368,5,1,4,10,1
6949,55,27,1673.6786356850528,5,3,2,10,1
6950,154,43,3503.7783883321663,3,5,4,12,1
6951,355,13,4829.260914678437,1,2,5,8,2
6952,200,17,379.4993484134304,3,2,1,6,3
6953,308,8,1329.876977810588,1,1,2,4,3
6954,356,32,1010.886960483057,1,4,1,6,3
6955,118,20,4350.217986585606,4,2,5,11,1
6956,263,17,904.1597444620651,2,2,1,5,3
6957,46,34,1547.2992199884236,5,4,2,11,1
6958,302,35,2723.865258897662,1,4,3,8,2
6959,356,35,3109.260834378879,1,4,4,9,2
6960,189,38,4042.836975037953,3,4,5,12,1
6961,310,42,2042.5430003039796,1,5,3,9,2
6962,318,24,2675.881166042925,1,3,3,7,2
6963,129,18,4827.655754470585,4,2,5,11,1
6964,49,46,1493.8350658505972,5,5,2,12,1
6965,25,48,1247.990113714971,5,5,2,12,1
6966,266,39,3555.8899647953403,2,4,4,10,1
6967,118,33,3857.969993290354,4,4,4,12,1
6968,144,49,2079.7467268697383,4,5,3,12,1
6969,200,23,1072.7648019272342,3,3,2,8,2
6970,157,25,3896.824052498848,3,3,4,10,1
6971,348,37,3355.7595474424,1,4,4,9,2
6972,134,27,4382.376728388394,4,3,5,12,1
6973,148,1,4223.189056992335,3,1,5,9,2
6974,336,21,1033.9239706761246,1,3,2,6,3
6975,71,49,4163.372508642515,5,5,5,15,0
6976,233,10,884.1169681833295,2,1,1,4,3
6977,334,31,4319.882479851749,1,4,5,10,1
6978,299,44,3853.901460823065,1,5,4,10,1
6979,154,25,2853.6067606691686,3,3,3,9,2
6980,90,20,3214.6861622941265,4,2,4,10,1
6981,334,2,529.3555616650435,1,1,1,3,3
6982,199,48,209.0270556167968,3,5,1,9,2
6983,161,15,1659.927241252204,3,2,2,7,2
6984,26,28,4108.814998971779,5,3,5,13,0
6985,121,13,2334.2700101680634,4,2,3,9,2
6986,301,14,1124.7362099655024,1,2,2,5,3
6987,212,2,4174.399010574931,3,1,5,9,2
6988,63,34,1150.850020658375,5,4,2,11,1
6989,68,35,4079.3136789723,5,4,5,14,0
6990,253,37,2270.36785928156,2,4,3,9,2
6991,2,25,2322.8394874637365,5,3,3,11,1
6992,108,48,1370.8708531926284,4,5,2,11,1
6993,286,15,4501.868364287769,2,2,5,9,2
6994,49,12,453.0385257137291,5,2,1,8,2
6995,140,9,730.5874435045872,4,1,1,6,3
6996,218,31,3183.0649935485767,2,4,4,10,1
6997,44,14,4252.075176124177,5,2,5,12,1
6998,269,29,486.3017384242857,2,3,1,6,3
6999,78,48,3671.423724588875,4,5,4,13,0
7000,216,43,3715.132550366037,3,5,4,12,1
7001,98,38,2911.7984235229915,4,4,3,11,1
7002,236,42,2438.772960366619,2,5,3,10,1
7003,282,8,1612.2279189445974,2,1,2,5,3
7004,149,48,1763.7943442390058,3,5,2,10,1
7005,304,3,3375.4230273531994,1,1,4,6,3
7006,66,2,335.7835831574124,5,1,1,7,2
7007,234,16,2928.8255878476816,2,2,3,7,2
7008,87,19,1400.873640339707,4,2,2,8,2
7009,79,30,2338.3635006002733,4,3,3,10,1
7010,205,41,2799.3082960664906,3,5,3,11,1
7011,279,16,4429.440124735313,2,2,5,9,2
7012,337,31,2899.5836927784503,1,4,3,8,2
7013,254,28,1143.526262478705,2,3,2,7,2
7014,304,4,406.5026713301613,1,1,1,3,3
7015,130,10,3138.6721139589486,4,1,4,9,2
7016,84,45,2729.791497792184,4,5,3,12,1
7017,276,18,3362.2715039145496,2,2,4,8,2
7018,187,47,2302.388929895312,3,5,3,11,1
7019,46,32,4127.377978191809,5,4,5,14,0
7020,183,30,4601.69661437078,3,3,5,11,1
7021,268,36,209.62206689589922,2,4,1,7,2
7022,296,9,3722.9918154539732,1,1,4,6,3
7023,322,36,185.45111828674237,1,4,1,6,3
7024,100,29,2231.032467493998,4,3,3,10,1
7025,78,16,2313.400051688887,4,2,3,9,2
7026,272,28,3484.1298036499006,2,3,4,9,2
7027,339,21,1768.4924580227253,1,3,2,6,3
7028,162,47,4106.297678207911,3,5,5,13,0
7029,44,2,1720.8916491498533,5,1,2,8,2
7030,238,46,1719.1642628240224,2,5,2,9,2
7031,134,35,1121.5757316166485,4,4,2,10,1
7032,192,28,3422.506299212043,3,3,4,10,1
7033,356,36,392.17026481112845,1,4,1,6,3
7034,278,31,1821.64487856499,2,4,2,8,2
7035,18,33,1341.7848232863182,5,4,2,11,1
7036,12,23,1154.384819156062,5,3,2,10,1
7037,180,41,314.3067526979668,3,5,1,9,2
7038,123,17,960.0117474667877,4,2,1,7,2
7039,246,46,2236.75960689152,2,5,3,10,1
7040,222,49,2523.6698617841093,2,5,3,10,1
7041,51,1,1354.828322211069,5,1,2,8,2
7042,71,42,3254.7151072481697,5,5,4,14,0
7043,48,23,1685.6087549083034,5,3,2,10,1
7044,19,48,1842.5567328656043,5,5,2,12,1
7045,262,27,3915.295427264326,2,3,4,9,2
7046,84,25,2764.3139399102615,4,3,3,10,1
7047,155,32,4766.342507458182,3,4,5,12,1
7048,53,19,1802.9129943130397,5,2,2,9,2
7049,107,24,4140.924075012073,4,3,5,12,1
7050,357,3,3694.304303680747,1,1,4,6,3
7051,304,12,4452.0427479350565,1,2,5,8,2
7052,135,35,4784.388950886174,4,4,5,13,0
7053,69,15,48.305825203336866,5,2,1,8,2
7054,11,17,450.60576185890534,5,2,1,8,2
7055,143,32,3374.950717925268,4,4,4,12,1
7056,192,7,1957.097299886065,3,1,2,6,3
7057,69,19,4097.434257696305,5,2,5,12,1
7058,23,7,69.77935003369555,5,1,1,7,2
7059,181,5,4036.8172409521876,3,1,5,9,2
7060,293,40,684.8575715352247,1,4,1,6,3
7061,9,21,1458.3427293735135,5,3,2,10,1
7062,271,48,4845.700219301166,2,5,5,12,1
7063,93,48,267.4745866053589,4,5,1,10,1
7064,17,47,1751.712656138843,5,5,2,12,1
7065,154,7,431.79859046109726,3,1,1,5,3
7066,328,37,4269.485986006707,1,4,5,10,1
7067,149,23,3518.050451461741,3,3,4,10,1
7068,267,11,4003.6835652004893,2,2,4,8,2
7069,328,10,2641.124763692244,1,1,3,5,3
7070,106,21,1795.0228981606417,4,3,2,9,2
7071,35,41,21.345361829579062,5,5,1,11,1
7072,119,33,1396.8572870941418,4,4,2,10,1
7073,14,20,2577.622198362912,5,2,3,10,1
7074,14,33,3325.166562015657,5,4,4,13,0
7075,266,40,1152.397733079196,2,4,2,8,2
7076,140,35,703.1152229777899,4,4,1,9,2
7077,294,34,1016.0581615290585,1,4,1,6,3
7078,364,36,1776.8394979386887,1,4,2,7,2
7079,119,27,750.4076730953666,4,3,1,8,2
7080,238,19,792.5184987613472,2,2,1,5,3
7081,34,43,228.32098303370907,5,5,1,11,1
7082,169,5,4285.058719828719,3,1,5,9,2
7083,10,29,1106.5955340631047,5,3,2,10,1
7084,122,10,4111.293170915823,4,1,5,10,1
7085,145,40,2197.1638368248205,4,4,3,11,1
7086,223,13,3165.86469542091,2,2,4,8,2
7087,257,29,387.75365942939465,2,3,1,6,3
7088,268,5,2922.0666889131217,2,1,3,6,3
7089,359,12,1457.0770618347758,1,2,2,5,3
7090,4,13,485.0976662244667,5,2,1,8,2
7091,354,22,4542.080155877499,1,3,5,9,2
7092,106,40,3022.1039313239594,4,4,3,11,1
7093,85,15,1216.1210599476547,4,2,2,8,2
7094,214,13,2104.043573504811,3,2,3,8,2
7095,121,1,1790.9316690577296,4,1,2,7,2
7096,132,38,3505.892532630529,4,4,4,12,1
7097,338,43,3041.091548377195,1,5,4,10,1
7098,197,45,108.7130585488152,3,5,1,9,2
7099,19,1,997.1566781273207,5,1,1,7,2
7100,130,11,2395.8585814818994,4,2,3,9,2
7101,12,43,2232.974103346415,5,5,3,13,0
7102,81,40,2588.207660898217,4,4,3,11,1
7103,330,22,3576.9060581985104,1,3,4,8,2
7104,354,35,3413.224902506153,1,4,4,9,2
7105,262,44,1870.3389764885371,2,5,2,9,2
7106,125,6,4389.13232341359,4,1,5,10,1
7107,307,28,324.0335265381085,1,3,1,5,3
7108,267,31,2926.704376607515,2,4,3,9,2
7109,140,8,4748.930607921953,4,1,5,10,1
7110,329,5,2749.916374748353,1,1,3,5,3
7111,2,42,2280.9804410561514,5,5,3,13,0
7112,8,48,678.248767595158,5,5,1,11,1
7113,250,44,4052.8435854053405,2,5,5,12,1
7114,139,17,1875.236501304151,4,2,2,8,2
7115,124,38,3509.217088328593,4,4,4,12,1
7116,309,9,995.7589332312147,1,1,1,3,3
7117,228,10,218.89738263142385,2,1,1,4,3
7118,10,20,1534.2825881147228,5,2,2,9,2
7119,212,14,1414.2551686698853,3,2,2,7,2
7120,112,14,4368.641515101099,4,2,5,11,1
7121,8,26,4324.722155137922,5,3,5,13,0
7122,292,29,2674.1321707808893,1,3,3,7,2
7123,362,49,104.80473840524614,1,5,1,7,2
7124,253,27,1149.3400679731753,2,3,2,7,2
7125,14,25,3198.6728451250315,5,3,4,12,1
7126,240,16,516.0279231375341,2,2,1,5,3
7127,242,36,3506.105100950041,2,4,4,10,1
7128,342,34,69.69169216412993,1,4,1,6,3
7129,149,16,3415.858509092659,3,2,4,9,2
7130,236,33,4224.250821868303,2,4,5,11,1
7131,306,3,2351.39642103412,1,1,3,5,3
7132,167,23,4147.114140649088,3,3,5,11,1
7133,20,11,3909.8233888869095,5,2,4,11,1
7134,216,48,3360.3815593367085,3,5,4,12,1
7135,343,18,2231.2949141751897,1,2,3,6,3
7136,135,47,1366.8011815634543,4,5,2,11,1
7137,129,41,4305.711171222654,4,5,5,14,0
7138,294,44,3246.465994518112,1,5,4,10,1
7139,246,29,3992.104007900375,2,3,4,9,2
7140,189,5,2764.3149693671703,3,1,3,7,2
7141,44,24,867.6135081246842,5,3,1,9,2
7142,86,29,4897.3953181725465,4,3,5,12,1
7143,44,29,921.8663697736107,5,3,1,9,2
7144,330,26,4557.095090114268,1,3,5,9,2
7145,145,40,1048.6118437644202,4,4,2,10,1
7146,51,3,1875.009714314715,5,1,2,8,2
7147,242,2,2206.016388241759,2,1,3,6,3
7148,294,25,4607.666187745444,1,3,5,9,2
7149,51,19,4442.110868856186,5,2,5,12,1
7150,266,40,4117.872679982655,2,4,5,11,1
7151,120,2,1889.608986003714,4,1,2,7,2
7152,200,19,32.4213016763116,3,2,1,6,3
7153,248,1,3411.1007673365216,2,1,4,7,2
7154,70,27,2060.6596339813673,5,3,3,11,1
7155,341,45,3787.7203822588035,1,5,4,10,1
7156,57,49,3976.3117099569154,5,5,4,14,0
7157,39,35,2204.2197805579467,5,4,3,12,1
7158,289,41,3743.0318009315724,2,5,4,11,1
7159,18,5,4201.28702979319,5,1,5,11,1
7160,220,38,4643.095896691486,2,4,5,11,1
7161,313,4,2916.4521091220777,1,1,3,5,3
7162,244,17,3894.609057608814,2,2,4,8,2
7163,352,21,2477.878702346139,1,3,3,7,2
7164,304,48,217.89837214551073,1,5,1,7,2
7165,298,31,784.5549247179249,1,4,1,6,3
7166,283,48,649.8403011059538,2,5,1,8,2
7167,74,22,867.1102946762396,4,3,1,8,2
7168,110,11,60.961620568087774,4,2,1,7,2
7169,180,34,4294.947048093111,3,4,5,12,1
7170,32,49,2805.1451065455717,5,5,3,13,0
7171,234,15,1921.9185150262256,2,2,2,6,3
7172,282,10,2054.796569169106,2,1,3,6,3
7173,25,38,2322.121957657159,5,4,3,12,1
7174,331,32,378.67866709376693,1,4,1,6,3
7175,279,48,1380.5804037838018,2,5,2,9,2
7176,226,31,4259.615921089503,2,4,5,11,1
7177,57,37,3720.9394287077826,5,4,4,13,0
7178,180,44,2821.393636,3,5,3,11,1
7179,232,28,2408.7128835031153,2,3,3,8,2
7180,343,31,1302.276193104588,1,4,2,7,2
7181,287,6,2361.562298539056,2,1,3,6,3
7182,64,14,2993.297827573406,5,2,3,10,1
7183,232,23,3566.063377643587,2,3,4,9,2
7184,289,16,841.5345368840958,2,2,1,5,3
7185,213,25,4067.420239669179,3,3,5,11,1
7186,258,39,1735.5982723987745,2,4,2,8,2
7187,18,2,2521.2578356188733,5,1,3,9,2
7188,175,38,3043.442539815699,3,4,4,11,1
7189,229,41,2445.594829542956,2,5,3,10,1
7190,226,39,2864.064951729054,2,4,3,9,2
7191,84,34,566.5020887675274,4,4,1,9,2
7192,291,40,2166.4557209920895,2,4,3,9,2
7193,246,43,1409.5326799717695,2,5,2,9,2
7194,110,25,439.2705078954822,4,3,1,8,2
7195,254,36,966.3296359036514,2,4,1,7,2
7196,88,16,3016.1983864730173,4,2,3,9,2
7197,72,18,991.4651492307371,5,2,1,8,2
7198,30,13,913.5094104942758,5,2,1,8,2
7199,172,37,2768.623857609315,3,4,3,10,1
7200,309,27,4524.465508467856,1,3,5,9,2
7201,343,34,3945.5773246927506,1,4,4,9,2
7202,177,11,4526.394661494053,3,2,5,10,1
7203,139,1,2919.0712094596106,4,1,3,8,2
7204,194,13,2055.54850668845,3,2,3,8,2
7205,186,30,3650.9104140542972,3,3,4,10,1
7206,218,5,1314.206500631428,2,1,2,5,3
7207,164,18,399.48925044696455,3,2,1,6,3
7208,161,14,1729.6278157283666,3,2,2,7,2
7209,13,13,1503.191120460217,5,2,2,9,2
7210,296,32,3380.9392498075395,1,4,4,9,2
7211,89,7,2761.2997672709535,4,1,3,8,2
7212,324,8,699.9322904383697,1,1,1,3,3
7213,42,7,4543.435857054644,5,1,5,11,1
7214,210,49,2970.761313118973,3,5,3,11,1
7215,229,16,2293.8442848646464,2,2,3,7,2
7216,350,43,4686.602686322081,1,5,5,11,1
7217,275,31,495.5362255015251,2,4,1,7,2
7218,279,27,3950.0687613171917,2,3,4,9,2
7219,251,33,1829.6808735428465,2,4,2,8,2
7220,310,29,3479.9948571106183,1,3,4,8,2
7221,208,8,4654.319883961916,3,1,5,9,2
7222,321,33,2593.3882716222324,1,4,3,8,2
7223,140,41,122.96772890944925,4,5,1,10,1
7224,280,19,153.95266855996638,2,2,1,5,3
7225,34,21,1659.4984872360287,5,3,2,10,1
7226,309,41,3910.4745147813587,1,5,4,10,1
7227,18,21,1448.424101937178,5,3,2,10,1
7228,57,25,1678.998318422226,5,3,2,10,1
7229,112,42,3924.458958855868,4,5,4,13,0
7230,5,23,589.7839778572114,5,3,1,9,2
7231,182,11,4235.596680194799,3,2,5,10,1
7232,13,33,1336.3046526149917,5,4,2,11,1
7233,339,20,265.603124434252,1,2,1,4,3
7234,285,25,595.5401049544095,2,3,1,6,3
7235,259,26,4763.248884826729,2,3,5,10,1
7236,90,40,2262.1065356689037,4,4,3,11,1
7237,104,12,1289.6261489323058,4,2,2,8,2
7238,186,32,2611.1420413941837,3,4,3,10,1
7239,250,33,3414.9098004350635,2,4,4,10,1
7240,255,10,1600.804056139906,2,1,2,5,3
7241,76,4,3629.1033037735097,4,1,4,9,2
7242,108,15,1268.7377340269381,4,2,2,8,2
7243,156,6,570.5627878997624,3,1,1,5,3
7244,82,27,2753.044019641783,4,3,3,10,1
7245,77,5,764.0821927117103,4,1,1,6,3
7246,258,5,4703.019544708708,2,1,5,8,2
7247,127,18,12.240650377935346,4,2,1,7,2
7248,282,28,3780.923538833067,2,3,4,9,2
7249,88,35,1404.5712877449853,4,4,2,10,1
7250,204,22,4231.973440244111,3,3,5,11,1
7251,16,34,310.1529098644725,5,4,1,10,1
7252,151,4,4765.472985514862,3,1,5,9,2
7253,254,18,515.960470326737,2,2,1,5,3
7254,188,41,3941.5349476268725,3,5,4,12,1
7255,329,26,2591.537646041666,1,3,3,7,2
7256,32,42,2157.6700114691494,5,5,3,13,0
7257,271,22,1407.9773716922552,2,3,2,7,2
7258,5,47,4208.433980892835,5,5,5,15,0
7259,330,33,1006.7594736894212,1,4,1,6,3
7260,308,43,3608.9939622143675,1,5,4,10,1
7261,333,14,2234.5003386297517,1,2,3,6,3
7262,169,31,4992.4900856648765,3,4,5,12,1
7263,181,10,3060.8811106471658,3,1,4,8,2
7264,178,24,529.9061230806044,3,3,1,7,2
7265,143,21,2103.4107338684776,4,3,3,10,1
7266,362,48,340.8319121221269,1,5,1,7,2
7267,248,8,1435.4216156016817,2,1,2,5,3
7268,127,32,1723.1508064567124,4,4,2,10,1
7269,263,31,4267.351275614618,2,4,5,11,1
7270,40,34,4191.557508271603,5,4,5,14,0
7271,355,23,67.67052771717199,1,3,1,5,3
7272,255,25,2666.070288875411,2,3,3,8,2
7273,143,7,1125.4833404603794,4,1,2,7,2
7274,240,19,1607.2645592473232,2,2,2,6,3
7275,228,7,118.0399147724206,2,1,1,4,3
7276,341,47,3751.2318685721116,1,5,4,10,1
7277,198,8,4753.442981004483,3,1,5,9,2
7278,65,14,1104.1425311661205,5,2,2,9,2
7279,11,1,1715.446606568684,5,1,2,8,2
7280,108,13,1040.1056337020225,4,2,2,8,2
7281,26,3,4650.9428315712275,5,1,5,11,1
7282,151,28,56.68627985805956,3,3,1,7,2
7283,221,38,2923.4727836422653,2,4,3,9,2
7284,341,15,4355.112165999528,1,2,5,8,2
7285,237,36,939.6727988355806,2,4,1,7,2
7286,237,3,2954.07650389679,2,1,3,6,3
7287,219,4,262.7340432757757,2,1,1,4,3
7288,151,5,4074.7798165033687,3,1,5,9,2
7289,123,26,1379.4013226369616,4,3,2,9,2
7290,144,25,4943.879551804351,4,3,5,12,1
7291,189,10,4610.828006243986,3,1,5,9,2
7292,255,8,3665.2546899642425,2,1,4,7,2
7293,68,12,2489.2447804437434,5,2,3,10,1
7294,104,3,3835.2796681859004,4,1,4,9,2
7295,336,27,661.7391472383831,1,3,1,5,3
7296,159,23,1557.8962016747141,3,3,2,8,2
7297,309,40,144.21297899851672,1,4,1,6,3
7298,362,33,3228.6729616326033,1,4,4,9,2
7299,300,14,4029.6328140267574,1,2,5,8,2
7300,90,23,4731.964912030707,4,3,5,12,1
7301,357,31,3435.670853400704,1,4,4,9,2
7302,256,13,3663.1352887114194,2,2,4,8,2
7303,353,12,4478.3243333924065,1,2,5,8,2
7304,220,35,4682.526364002049,2,4,5,11,1
7305,9,18,2461.5747738498317,5,2,3,10,1
7306,12,21,557.8390746442886,5,3,1,9,2
7307,325,45,2337.4223762620645,1,5,3,9,2
7308,244,47,2784.808575732726,2,5,3,10,1
7309,182,42,3161.4084092637645,3,5,4,12,1
7310,284,1,4946.529940973274,2,1,5,8,2
7311,312,38,4588.640444300945,1,4,5,10,1
7312,99,41,1987.857371701185,4,5,2,11,1
7313,197,42,576.1338944908421,3,5,1,9,2
7314,226,47,1081.8100751311283,2,5,2,9,2
7315,333,9,877.2601179387685,1,1,1,3,3
7316,103,23,1786.503508473493,4,3,2,9,2
7317,106,14,4383.681526886708,4,2,5,11,1
7318,58,11,2195.462845682109,5,2,3,10,1
7319,78,7,2840.714083275307,4,1,3,8,2
7320,75,31,904.0427054451872,4,4,1,9,2
7321,42,24,2469.3129221121385,5,3,3,11,1
7322,324,26,4369.402329787457,1,3,5,9,2
7323,181,30,3869.5816849552034,3,3,4,10,1
7324,33,34,415.14167183711777,5,4,1,10,1
7325,71,46,4311.740621063074,5,5,5,15,0
7326,56,38,1376.4022061254334,5,4,2,11,1
7327,105,5,3331.924084206437,4,1,4,9,2
7328,200,5,740.4506966622293,3,1,1,5,3
7329,101,19,3376.475406728153,4,2,4,10,1
7330,256,38,188.15012999724496,2,4,1,7,2
7331,307,28,3007.217058340387,1,3,3,7,2
7332,74,26,3233.241452099108,4,3,4,11,1
7333,171,42,1230.03860315473,3,5,2,10,1
7334,143,23,4685.510687655295,4,3,5,12,1
7335,166,46,239.40221213039254,3,5,1,9,2
7336,261,49,4459.629540656845,2,5,5,12,1
7337,221,30,1915.6684633362295,2,3,2,7,2
7338,83,3,3572.4345610955043,4,1,4,9,2
7339,182,28,3261.226652466198,3,3,4,10,1
7340,307,33,849.5486179796975,1,4,1,6,3
7341,10,42,1601.806385193395,5,5,2,12,1
7342,4,3,2653.070669753544,5,1,3,9,2
7343,351,5,4234.086249219188,1,1,5,7,2
7344,336,19,4774.751778917989,1,2,5,8,2
7345,292,42,112.72730035283637,1,5,1,7,2
7346,281,48,1769.265694800333,2,5,2,9,2
7347,215,1,3344.0381836664887,3,1,4,8,2
7348,98,38,2643.3698718809087,4,4,3,11,1
7349,101,9,4715.680358125227,4,1,5,10,1
7350,9,5,94.67747833437949,5,1,1,7,2
7351,61,46,2194.319599102003,5,5,3,13,0
7352,309,42,3347.331200545065,1,5,4,10,1
7353,146,34,1095.7427322011001,4,4,2,10,1
7354,63,37,3632.0982167135926,5,4,4,13,0
7355,121,33,415.3308548243294,4,4,1,9,2
7356,226,25,2260.682262111764,2,3,3,8,2
7357,105,42,3384.412431391617,4,5,4,13,0
7358,260,29,1341.118069920003,2,3,2,7,2
7359,349,25,378.49362419956134,1,3,1,5,3
7360,255,9,4785.53783289922,2,1,5,8,2
7361,207,3,4569.976913688361,3,1,5,9,2
7362,28,15,4632.585858942547,5,2,5,12,1
7363,170,4,4892.726892655663,3,1,5,9,2
7364,336,45,931.643291512744,1,5,1,7,2
7365,76,38,797.3022289843017,4,4,1,9,2
7366,116,20,180.7307851763084,4,2,1,7,2
7367,69,49,4460.195710212734,5,5,5,15,0
7368,354,23,3766.286577268401,1,3,4,8,2
7369,234,37,3169.9794314812857,2,4,4,10,1
7370,1,47,4639.104034338825,5,5,5,15,0
7371,167,8,2879.6323063175605,3,1,3,7,2
7372,352,37,657.3564561004846,1,4,1,6,3
7373,218,45,892.5537299256894,2,5,1,8,2
7374,273,33,669.5978123871015,2,4,1,7,2
7375,251,33,1545.213483487932,2,4,2,8,2
7376,347,7,1903.6891972369328,1,1,2,4,3
7377,344,22,3986.2269327765903,1,3,4,8,2
7378,174,5,964.3570181122637,3,1,1,5,3
7379,170,46,3629.5721126900735,3,5,4,12,1
7380,246,15,2461.2302255513932,2,2,3,7,2
7381,90,21,4998.303006430081,4,3,5,12,1
7382,49,25,3885.1464806138965,5,3,4,12,1
7383,294,17,4845.075413379931,1,2,5,8,2
7384,150,7,1718.3339931602884,3,1,2,6,3
7385,132,19,624.0204638996267,4,2,1,7,2
7386,59,7,2534.4200676745777,5,1,3,9,2
7387,324,40,629.9549745787352,1,4,1,6,3
7388,199,45,2467.3340072617034,3,5,3,11,1
7389,215,24,1357.0057206151482,3,3,2,8,2
7390,49,11,2460.3255900161525,5,2,3,10,1
7391,232,41,4748.684656073609,2,5,5,12,1
7392,247,1,1452.279980475251,2,1,2,5,3
7393,239,32,4967.23590635411,2,4,5,11,1
7394,168,40,1154.3540523263866,3,4,2,9,2
7395,48,44,1048.4608111951966,5,5,2,12,1
7396,51,2,2728.494729765954,5,1,3,9,2
7397,299,15,4211.804242197267,1,2,5,8,2
7398,98,21,3750.0225607168964,4,3,4,11,1
7399,216,24,3620.4493071268657,3,3,4,10,1
7400,177,17,1420.3383763491331,3,2,2,7,2
7401,80,47,122.35871259091557,4,5,1,10,1
7402,185,9,817.1239678198195,3,1,1,5,3
7403,27,35,1753.871772684471,5,4,2,11,1
7404,195,20,4858.701915345301,3,2,5,10,1
7405,214,19,4599.689515289659,3,2,5,10,1
7406,342,18,1011.2164904578352,1,2,1,4,3
7407,114,20,3630.8561651436316,4,2,4,10,1
7408,242,30,2899.2941159478733,2,3,3,8,2
7409,124,40,258.71482393775403,4,4,1,9,2
7410,305,1,1864.8110003799627,1,1,2,4,3
7411,76,24,2435.507964425854,4,3,3,10,1
7412,311,24,3341.194875517008,1,3,4,8,2
7413,312,47,1481.576528912073,1,5,2,8,2
7414,196,19,4669.754958981866,3,2,5,10,1
7415,351,30,2264.8764929513113,1,3,3,7,2
7416,44,26,1250.162824343656,5,3,2,10,1
7417,186,42,1588.9761553637659,3,5,2,10,1
7418,343,44,3761.9082888086314,1,5,4,10,1
7419,246,38,3205.023984197071,2,4,4,10,1
7420,84,29,3713.4683270144424,4,3,4,11,1
7421,207,13,1468.78570835129,3,2,2,7,2
7422,151,4,1640.9746063326866,3,1,2,6,3
7423,156,45,1989.6283915884176,3,5,2,10,1
7424,16,17,951.0790624900699,5,2,1,8,2
7425,165,33,3458.312279231878,3,4,4,11,1
7426,145,5,1653.4540752484647,4,1,2,7,2
7427,37,28,1637.9187584682873,5,3,2,10,1
7428,333,24,1354.131199736828,1,3,2,6,3
7429,45,17,2269.6107454601124,5,2,3,10,1
7430,206,39,3862.160635378711,3,4,4,11,1
7431,62,48,4179.687440236784,5,5,5,15,0
7432,356,40,4024.4943096393013,1,4,5,10,1
7433,308,44,3109.755952283316,1,5,4,10,1
7434,19,46,1409.3333999408082,5,5,2,12,1
7435,300,11,3676.927476983805,1,2,4,7,2
7436,7,12,206.41608929322223,5,2,1,8,2
7437,249,13,3992.780512479137,2,2,4,8,2
7438,117,8,3903.335544692208,4,1,4,9,2
7439,68,1,3353.3055547506247,5,1,4,10,1
7440,34,9,498.64799542803286,5,1,1,7,2
7441,194,28,4986.733264286205,3,3,5,11,1
7442,325,2,3784.4818700809665,1,1,4,6,3
7443,55,14,3676.686086729386,5,2,4,11,1
7444,266,13,329.39918412126445,2,2,1,5,3
7445,42,48,1999.538581598764,5,5,2,12,1
7446,297,2,440.0032682384374,1,1,1,3,3
7447,231,4,1811.5746639771132,2,1,2,5,3
7448,10,12,2856.722916242345,5,2,3,10,1
7449,358,48,4395.57221989951,1,5,5,11,1
7450,128,10,1421.8592876425394,4,1,2,7,2
7451,179,3,3120.83911588655,3,1,4,8,2
7452,193,4,831.6130925005801,3,1,1,5,3
7453,92,6,1776.2796461416983,4,1,2,7,2
7454,231,23,4736.7150014293,2,3,5,10,1
7455,78,5,3740.7281687578306,4,1,4,9,2
7456,85,3,2733.570763293987,4,1,3,8,2
7457,30,10,1265.9670277892465,5,1,2,8,2
7458,213,43,1904.7290609930049,3,5,2,10,1
7459,49,19,791.8997359240474,5,2,1,8,2
7460,265,14,1773.8012935543338,2,2,2,6,3
7461,145,21,761.6578031730897,4,3,1,8,2
7462,69,43,3978.58209472546,5,5,4,14,0
7463,58,28,412.9878588120181,5,3,1,9,2
7464,185,21,955.1333442374544,3,3,1,7,2
7465,62,36,3458.9219816059617,5,4,4,13,0
7466,308,24,4513.558394978689,1,3,5,9,2
7467,296,38,4823.312132740332,1,4,5,10,1
7468,166,17,4181.754354536476,3,2,5,10,1
7469,171,22,1065.2441640674624,3,3,2,8,2
7470,63,19,1435.6993163019283,5,2,2,9,2
7471,147,45,4355.054241462779,3,5,5,13,0
7472,306,10,4447.771494073113,1,1,5,7,2
7473,161,11,3206.859297442361,3,2,4,9,2
7474,141,38,1575.0690849424814,4,4,2,10,1
7475,334,2,1128.0427485994237,1,1,2,4,3
7476,97,33,4262.890669321105,4,4,5,13,0
7477,221,43,1034.2224422642814,2,5,2,9,2
7478,43,31,3312.403709905261,5,4,4,13,0
7479,292,48,4840.087180243319,1,5,5,11,1
7480,108,35,3529.404048573974,4,4,4,12,1
7481,266,37,1295.7748626913417,2,4,2,8,2
7482,95,47,1419.70444735948,4,5,2,11,1
7483,262,47,473.544929350318,2,5,1,8,2
7484,313,36,3434.3250749044523,1,4,4,9,2
7485,71,23,2596.9940505043587,5,3,3,11,1
7486,219,36,1040.2937806854736,2,4,2,8,2
7487,21,40,1146.0648197416563,5,4,2,11,1
7488,92,39,55.03252828824373,4,4,1,9,2
7489,127,26,4892.312801542164,4,3,5,12,1
7490,80,25,4141.810745849248,4,3,5,12,1
7491,312,17,1976.9080531358334,1,2,2,5,3
7492,238,15,4730.988355462518,2,2,5,9,2
7493,182,37,3388.8284963804635,3,4,4,11,1
7494,25,45,3759.79805278279,5,5,4,14,0
7495,156,4,3402.9779443699645,3,1,4,8,2
7496,5,22,3786.67567145191,5,3,4,12,1
7497,120,17,862.9852513965275,4,2,1,7,2
7498,277,22,2816.366007698642,2,3,3,8,2
7499,18,17,4248.387614188403,5,2,5,12,1
7500,198,14,107.51749401059126,3,2,1,6,3
7501,57,14,625.9803374088199,5,2,1,8,2
7502,93,17,1235.7426502088347,4,2,2,8,2
7503,19,8,1480.6862166711078,5,1,2,8,2
7504,353,34,921.6922942877677,1,4,1,6,3
7505,193,26,3125.40864575602,3,3,4,10,1
7506,237,45,1477.15516525678,2,5,2,9,2
7507,277,30,798.9182201308217,2,3,1,6,3
7508,227,22,4530.072649112134,2,3,5,10,1
7509,233,16,3478.222312421174,2,2,4,8,2
7510,40,30,1237.8331454098723,5,3,2,10,1
7511,323,16,1811.1586302227472,1,2,2,5,3
7512,153,38,3706.519958814606,3,4,4,11,1
7513,127,24,3956.64126711669,4,3,4,11,1
7514,237,36,890.4164654469432,2,4,1,7,2
7515,55,35,4683.514659527921,5,4,5,14,0
7516,172,6,3928.506975560161,3,1,4,8,2
7517,109,4,4285.504041297931,4,1,5,10,1
7518,354,18,727.8554467468637,1,2,1,4,3
7519,184,6,725.4020895447813,3,1,1,5,3
7520,198,26,1533.7905326845837,3,3,2,8,2
7521,87,37,332.58563392861515,4,4,1,9,2
7522,201,27,464.4259610102968,3,3,1,7,2
7523,337,41,724.6037060444868,1,5,1,7,2
7524,322,11,3565.0243660978863,1,2,4,7,2
7525,275,38,160.84915528958385,2,4,1,7,2
7526,211,16,425.39145902931693,3,2,1,6,3
7527,118,19,4721.475845566551,4,2,5,11,1
7528,191,43,427.44684154499697,3,5,1,9,2
7529,42,15,2691.9372276423187,5,2,3,10,1
7530,42,26,3216.4402293910853,5,3,4,12,1
7531,315,41,4793.381633439322,1,5,5,11,1
7532,276,31,4500.015562379103,2,4,5,11,1
7533,329,19,2209.007008261144,1,2,3,6,3
7534,17,24,4711.398665969359,5,3,5,13,0
7535,283,9,2167.0067152416113,2,1,3,6,3
7536,258,23,3352.894390198455,2,3,4,9,2
7537,63,4,1305.4442728837855,5,1,2,8,2
7538,62,10,3186.856184188821,5,1,4,10,1
7539,100,9,2695.562833597241,4,1,3,8,2
7540,19,19,3038.086903343684,5,2,4,11,1
7541,17,15,3416.429494654971,5,2,4,11,1
7542,325,34,875.5419475096661,1,4,1,6,3
7543,246,42,1513.301376868553,2,5,2,9,2
7544,251,19,3683.844520758385,2,2,4,8,2
7545,81,49,827.4816914907052,4,5,1,10,1
7546,39,21,1727.7582922075649,5,3,2,10,1
7547,36,34,3335.7286685545337,5,4,4,13,0
7548,197,17,4688.878416106451,3,2,5,10,1
7549,158,18,385.74803192982466,3,2,1,6,3
7550,204,17,2587.638387462445,3,2,3,8,2
7551,196,2,418.70764279639195,3,1,1,5,3
7552,216,1,1901.8684352481878,3,1,2,6,3
7553,285,43,885.1786553958533,2,5,1,8,2
7554,196,10,3250.6977286667816,3,1,4,8,2
7555,307,37,3791.584434253922,1,4,4,9,2
7556,152,48,1244.2426007288293,3,5,2,10,1
7557,14,5,3567.3068737732024,5,1,4,10,1
7558,325,12,2239.6264999048317,1,2,3,6,3
7559,146,36,1425.0643516414598,4,4,2,10,1
7560,57,31,2621.7743267468054,5,4,3,12,1
7561,211,38,1904.4542176666184,3,4,2,9,2
7562,268,9,1157.6813102306812,2,1,2,5,3
7563,210,44,3786.6555326886214,3,5,4,12,1
7564,17,26,3989.6455031871615,5,3,4,12,1
7565,286,15,4003.5580813674674,2,2,4,8,2
7566,344,16,1916.892552218116,1,2,2,5,3
7567,203,13,855.9469725327707,3,2,1,6,3
7568,99,25,4203.6522947223175,4,3,5,12,1
7569,279,30,1653.0267436662048,2,3,2,7,2
7570,209,7,3742.853343237577,3,1,4,8,2
7571,129,4,4089.0782996101325,4,1,5,10,1
7572,335,43,3843.0809630377616,1,5,4,10,1
7573,288,40,1955.1320931471303,2,4,2,8,2
7574,252,38,4690.703465680459,2,4,5,11,1
7575,265,30,3304.210459847215,2,3,4,9,2
7576,271,10,2882.973958763403,2,1,3,6,3
7577,188,30,3492.566419354319,3,3,4,10,1
7578,214,39,233.1883450942965,3,4,1,8,2
7579,283,7,1958.6697141654035,2,1,2,5,3
7580,211,36,4407.2735976925915,3,4,5,12,1
7581,76,35,813.7877104636136,4,4,1,9,2
7582,148,24,2077.859232204285,3,3,3,9,2
7583,321,39,2032.1874759481345,1,4,3,8,2
7584,213,36,1786.6481364080921,3,4,2,9,2
7585,109,45,2816.13313100631,4,5,3,12,1
7586,129,20,4981.028267432616,4,2,5,11,1
7587,10,49,1286.6857554452822,5,5,2,12,1
7588,47,32,3527.736041649208,5,4,4,13,0
7589,315,39,3792.395038900597,1,4,4,9,2
7590,96,49,2926.647413601515,4,5,3,12,1
7591,103,26,496.40368262689316,4,3,1,8,2
7592,342,26,2866.1437517530335,1,3,3,7,2
7593,146,36,4767.787733605712,4,4,5,13,0
7594,27,43,1716.8801204994807,5,5,2,12,1
7595,220,35,3202.0437506333474,2,4,4,10,1
7596,18,43,4797.394684801989,5,5,5,15,0
7597,167,35,3991.971503361387,3,4,4,11,1
7598,82,12,3444.6555711882443,4,2,4,10,1
7599,72,33,4856.032905053888,5,4,5,14,0
7600,310,36,861.208946941013,1,4,1,6,3
7601,254,14,3866.0164546141946,2,2,4,8,2
7602,162,33,2040.1104789406393,3,4,3,10,1
7603,327,46,1808.5541215257163,1,5,2,8,2
7604,38,45,2608.155846865782,5,5,3,13,0
7605,201,45,178.41778329951646,3,5,1,9,2
7606,200,24,1569.5228084325304,3,3,2,8,2
7607,255,15,839.4153176718253,2,2,1,5,3
7608,179,31,702.0675880923505,3,4,1,8,2
7609,35,17,1693.3291450002896,5,2,2,9,2
7610,82,12,4013.299146473439,4,2,4,10,1
7611,220,22,1013.5442285967929,2,3,1,6,3
7612,158,23,2661.7647643177243,3,3,3,9,2
7613,4,26,3745.794408235423,5,3,4,12,1
7614,167,14,1212.4479591765416,3,2,2,7,2
7615,204,12,4621.774445821302,3,2,5,10,1
7616,194,4,4333.824537624701,3,1,5,9,2
7617,235,46,1263.3792765518745,2,5,2,9,2
7618,206,13,4948.293956155311,3,2,5,10,1
7619,150,18,3349.1637596339315,3,2,4,9,2
7620,159,43,1437.6391867277978,3,5,2,10,1
7621,279,28,3408.3769019747847,2,3,4,9,2
7622,304,38,3334.5788693124246,1,4,4,9,2
7623,166,41,3034.906187424302,3,5,3,11,1
7624,311,44,3561.3635942815895,1,5,4,10,1
7625,68,19,1348.8952949724478,5,2,2,9,2
7626,88,46,4895.137573091777,4,5,5,14,0
7627,217,47,4290.899828803039,3,5,5,13,0
7628,1,43,3731.2493496203115,5,5,4,14,0
7629,135,38,141.2619180802131,4,4,1,9,2
7630,185,46,2956.023012520614,3,5,3,11,1
7631,351,3,3535.355100830479,1,1,4,6,3
7632,140,19,4271.958137268337,4,2,5,11,1
7633,106,20,4731.324037726823,4,2,5,11,1
7634,133,25,4580.106968709345,4,3,5,12,1
7635,108,11,2036.1642130886144,4,2,3,9,2
7636,178,17,4483.540927990025,3,2,5,10,1
7637,298,49,13.736557982207255,1,5,1,7,2
7638,358,35,1763.8613054238547,1,4,2,7,2
7639,359,14,578.2665354596643,1,2,1,4,3
7640,146,39,4416.50782325051,4,4,5,13,0
7641,74,19,4640.629708113591,4,2,5,11,1
7642,108,3,1287.4820065696163,4,1,2,7,2
7643,122,34,1842.879136146062,4,4,2,10,1
7644,17,49,4919.549320891291,5,5,5,15,0
7645,196,41,2834.656684009688,3,5,3,11,1
7646,327,22,2490.3086586739814,1,3,3,7,2
7647,318,38,2507.1727708327203,1,4,3,8,2
7648,297,27,3483.9790145711854,1,3,4,8,2
7649,252,21,4773.169743512349,2,3,5,10,1
7650,119,41,1839.4459244643404,4,5,2,11,1
7651,162,31,871.5631512837243,3,4,1,8,2
7652,198,27,933.2143318434223,3,3,1,7,2
7653,45,37,111.59160004368438,5,4,1,10,1
7654,314,2,2781.498375635278,1,1,3,5,3
7655,179,47,4646.294922163549,3,5,5,13,0
7656,44,9,3568.25370794095,5,1,4,10,1
7657,271,19,4964.89298759663,2,2,5,9,2
7658,78,42,4548.541763053024,4,5,5,14,0
7659,326,36,2464.3697902182166,1,4,3,8,2
7660,178,10,2437.8814091500785,3,1,3,7,2
7661,357,40,3145.5025768445553,1,4,4,9,2
7662,3,45,563.5686310375322,5,5,1,11,1
7663,214,39,3042.3443598518356,3,4,4,11,1
7664,342,7,2325.7293588609728,1,1,3,5,3
7665,74,4,3217.2747290963307,4,1,4,9,2
7666,51,15,2830.39774174311,5,2,3,10,1
7667,67,12,1558.8753428197479,5,2,2,9,2
7668,332,48,3042.7322952618497,1,5,4,10,1
7669,93,6,1836.411620819702,4,1,2,7,2
7670,176,9,981.1594918326113,3,1,1,5,3
7671,145,35,3378.6035303125777,4,4,4,12,1
7672,7,8,1538.6719941627152,5,1,2,8,2
7673,269,7,4446.23365153152,2,1,5,8,2
7674,322,4,1004.6689739739261,1,1,1,3,3
7675,4,13,3004.7187517782445,5,2,3,10,1
7676,138,19,2862.0283864977737,4,2,3,9,2
7677,231,7,996.7315859977463,2,1,1,4,3
7678,88,10,2205.0353259340536,4,1,3,8,2
7679,17,25,3380.9384699985435,5,3,4,12,1
7680,52,44,1599.4507504049711,5,5,2,12,1
7681,134,35,578.0149804632504,4,4,1,9,2
7682,211,25,3080.0511676398246,3,3,4,10,1
7683,325,29,1128.3682922799753,1,3,2,6,3
7684,219,12,3410.5601485512425,2,2,4,8,2
7685,205,47,4198.940811954995,3,5,5,13,0
7686,211,40,625.54330353448,3,4,1,8,2
7687,277,12,2193.6694200842917,2,2,3,7,2
7688,24,6,2230.1621240505256,5,1,3,9,2
7689,4,10,3166.3542340849276,5,1,4,10,1
7690,152,2,1678.6955646998642,3,1,2,6,3
7691,259,45,2098.660086388013,2,5,3,10,1
7692,324,25,69.83630770099367,1,3,1,5,3
7693,357,7,620.9052968044639,1,1,1,3,3
7694,168,40,2853.6118767794705,3,4,3,10,1
7695,176,23,1087.32004347219,3,3,2,8,2
7696,310,48,731.4386800839115,1,5,1,7,2
7697,291,11,1628.8197121411743,2,2,2,6,3
7698,56,36,826.0431177162861,5,4,1,10,1
7699,108,49,307.5159580257337,4,5,1,10,1
7700,296,48,1426.452663229435,1,5,2,8,2
7701,324,23,830.1486224,1,3,1,5,3
7702,302,43,3998.9847542508332,1,5,4,10,1
7703,334,7,322.65826498400907,1,1,1,3,3
7704,141,27,3739.7417514657936,4,3,4,11,1
7705,155,13,1920.153773941177,3,2,2,7,2
7706,262,17,3379.8533336534815,2,2,4,8,2
7707,273,32,272.92028730361204,2,4,1,7,2
7708,232,26,4604.312933999959,2,3,5,10,1
7709,241,22,3839.204729285531,2,3,4,9,2
7710,355,13,709.3139286523884,1,2,1,4,3
7711,337,12,1101.7340114265282,1,2,2,5,3
7712,258,7,3223.541200871034,2,1,4,7,2
7713,249,1,4608.597395428808,2,1,5,8,2
7714,77,33,2234.703631121105,4,4,3,11,1
7715,180,14,2433.30764715881,3,2,3,8,2
7716,66,47,1196.623304331258,5,5,2,12,1
7717,308,43,1921.2242693494497,1,5,2,8,2
7718,348,41,1437.2283371232254,1,5,2,8,2
7719,171,17,1759.3500366926874,3,2,2,7,2
7720,22,4,112.78214752918258,5,1,1,7,2
7721,107,39,214.89311591446636,4,4,1,9,2
7722,323,1,3406.6258042054255,1,1,4,6,3
7723,227,41,3412.1579927239172,2,5,4,11,1
7724,216,45,1657.8506956758165,3,5,2,10,1
7725,69,24,4428.457359801646,5,3,5,13,0
7726,84,34,1337.8994598376175,4,4,2,10,1
7727,103,34,1984.9660620497293,4,4,2,10,1
7728,39,24,3659.564365172949,5,3,4,12,1
7729,13,15,3720.404907775594,5,2,4,11,1
7730,297,17,4307.217155898867,1,2,5,8,2
7731,313,13,155.0046191107525,1,2,1,4,3
7732,181,7,926.9558188943806,3,1,1,5,3
7733,268,9,3206.4531356436037,2,1,4,7,2
7734,13,44,1697.6168484896546,5,5,2,12,1
7735,120,35,227.3727379450321,4,4,1,9,2
7736,353,23,2936.4687027943755,1,3,3,7,2
7737,57,47,1971.4352603394098,5,5,2,12,1
7738,40,39,1826.833344134645,5,4,2,11,1
7739,336,23,1329.177780582271,1,3,2,6,3
7740,128,26,39.929486653643565,4,3,1,8,2
7741,173,1,919.9764846834281,3,1,1,5,3
7742,35,14,2376.4341361148395,5,2,3,10,1
7743,259,32,1385.924900908156,2,4,2,8,2
7744,5,48,4373.199509524641,5,5,5,15,0
7745,218,10,723.5683141602683,2,1,1,4,3
7746,11,1,4377.948032310645,5,1,5,11,1
7747,327,5,2030.0807843935793,1,1,3,5,3
7748,117,3,1386.4431622128836,4,1,2,7,2
7749,184,49,1528.4163739890494,3,5,2,10,1
7750,362,27,1657.0532562166707,1,3,2,6,3
7751,116,22,2537.7542835650665,4,3,3,10,1
7752,162,18,1775.8727332063847,3,2,2,7,2
7753,67,16,3239.559671720556,5,2,4,11,1
7754,200,2,2131.643245343826,3,1,3,7,2
7755,31,47,3361.5021113167077,5,5,4,14,0
7756,75,13,3026.087827574494,4,2,3,9,2
7757,237,45,1229.8253224220143,2,5,2,9,2
7758,327,16,4065.7387063719407,1,2,5,8,2
7759,66,8,3996.917524186888,5,1,4,10,1
7760,70,43,4945.012530411714,5,5,5,15,0
7761,297,8,883.5001708229474,1,1,1,3,3
7762,20,10,4240.71271417569,5,1,5,11,1
7763,226,33,4361.184803487649,2,4,5,11,1
7764,199,31,3214.399191345827,3,4,4,11,1
7765,39,12,2536.860041135625,5,2,3,10,1
7766,145,9,4786.725185283476,4,1,5,10,1
7767,45,37,4863.732720102883,5,4,5,14,0
7768,326,9,3212.0703071475837,1,1,4,6,3
7769,91,48,1804.2036910415707,4,5,2,11,1
7770,238,18,4087.65426549506,2,2,5,9,2
7771,70,30,455.3847814024655,5,3,1,9,2
7772,166,32,1460.0722637086344,3,4,2,9,2
7773,130,40,4927.9159309165225,4,4,5,13,0
7774,214,23,4073.5236021627775,3,3,5,11,1
7775,340,11,4698.516533129928,1,2,5,8,2
7776,89,20,2978.024911214927,4,2,3,9,2
7777,335,19,2044.2855661590984,1,2,3,6,3
7778,252,36,4898.653615921279,2,4,5,11,1
7779,349,26,1554.033673427202,1,3,2,6,3
7780,72,10,3789.4972517555275,5,1,4,10,1
7781,165,24,2795.4527199220393,3,3,3,9,2
7782,49,13,1150.2506561171822,5,2,2,9,2
7783,52,46,97.24160416862786,5,5,1,11,1
7784,289,34,1924.9828116153765,2,4,2,8,2
7785,278,29,2742.9501104577703,2,3,3,8,2
7786,114,36,924.1201007577984,4,4,1,9,2
7787,239,7,2078.628880447521,2,1,3,6,3
7788,133,30,3079.79775398821,4,3,4,11,1
7789,274,17,3577.466400841411,2,2,4,8,2
7790,166,48,273.18522423362157,3,5,1,9,2
7791,293,13,3324.2623007937805,1,2,4,7,2
7792,243,24,292.76987129982217,2,3,1,6,3
7793,320,31,150.64562184312547,1,4,1,6,3
7794,138,27,770.5360092934236,4,3,1,8,2
7795,79,21,3271.683845485711,4,3,4,11,1
7796,170,44,273.5789999934388,3,5,1,9,2
7797,123,1,114.27209890581496,4,1,1,6,3
7798,176,15,598.6179616242939,3,2,1,6,3
7799,300,3,4749.10774364575,1,1,5,7,2
7800,82,6,4537.31597213681,4,1,5,10,1
7801,87,14,441.46521574727365,4,2,1,7,2
7802,225,38,1527.0257857476495,2,4,2,8,2
7803,16,33,4736.989270845861,5,4,5,14,0
7804,310,38,497.46149054794097,1,4,1,6,3
7805,358,8,482.0339500853609,1,1,1,3,3
7806,163,26,439.15944969629743,3,3,1,7,2
7807,98,15,4882.616433102393,4,2,5,11,1
7808,156,14,3718.1114812793385,3,2,4,9,2
7809,2,48,1080.2769931228993,5,5,2,12,1
7810,350,20,239.27683386954973,1,2,1,4,3
7811,169,48,4826.555129468552,3,5,5,13,0
7812,315,19,2133.190318380859,1,2,3,6,3
7813,325,33,2995.8931875919234,1,4,3,8,2
7814,92,36,1403.1892051556456,4,4,2,10,1
7815,181,24,3794.218008231754,3,3,4,10,1
7816,231,10,992.0437060111421,2,1,1,4,3
7817,301,34,3936.690547543817,1,4,4,9,2
7818,148,36,1160.709186241823,3,4,2,9,2
7819,280,47,498.582006163876,2,5,1,8,2
7820,189,36,2399.32454710871,3,4,3,10,1
7821,347,16,4067.9518664092975,1,2,5,8,2
7822,350,15,1930.4748353462246,1,2,2,5,3
7823,314,18,154.07951683970745,1,2,1,4,3
7824,128,7,2771.0154643683363,4,1,3,8,2
7825,7,47,3405.5522307284023,5,5,4,14,0
7826,47,22,3706.0677772266736,5,3,4,12,1
7827,53,32,2015.605522003327,5,4,3,12,1
7828,187,43,494.1279611470788,3,5,1,9,2
7829,38,19,2925.788907972298,5,2,3,10,1
7830,226,40,1654.443947338527,2,4,2,8,2
7831,53,1,4734.968536551516,5,1,5,11,1
7832,224,35,2518.533419226025,2,4,3,9,2
7833,154,5,2366.6075735269037,3,1,3,7,2
7834,48,12,1552.9555662686005,5,2,2,9,2
7835,351,12,1700.5446618639041,1,2,2,5,3
7836,147,21,2568.646372558761,3,3,3,9,2
7837,64,19,1540.257328621824,5,2,2,9,2
7838,349,9,4462.601372998377,1,1,5,7,2
7839,182,43,2200.6994828212523,3,5,3,11,1
7840,125,49,1467.1901992249914,4,5,2,11,1
7841,179,48,785.4202193703353,3,5,1,9,2
7842,39,36,3365.030124238787,5,4,4,13,0
7843,260,42,138.67684699506447,2,5,1,8,2
7844,3,47,2255.4789779780026,5,5,3,13,0
7845,64,32,2755.1078836324473,5,4,3,12,1
7846,29,35,1705.5252082928548,5,4,2,11,1
7847,11,31,3751.5905589022786,5,4,4,13,0
7848,97,32,3381.545879221315,4,4,4,12,1
7849,358,37,4857.280947974109,1,4,5,10,1
7850,203,32,2548.746328455513,3,4,3,10,1
7851,21,43,2693.683699500621,5,5,3,13,0
7852,39,37,1236.7382027771728,5,4,2,11,1
7853,223,39,1933.5646147462955,2,4,2,8,2
7854,102,38,144.0343498799368,4,4,1,9,2
7855,46,30,3449.481195102471,5,3,4,12,1
7856,66,32,1564.9977704208648,5,4,2,11,1
7857,91,45,2706.4313782368226,4,5,3,12,1
7858,164,2,1282.4120580906358,3,1,2,6,3
7859,111,11,3108.970639694897,4,2,4,10,1
7860,338,20,2243.4366398406814,1,2,3,6,3
7861,123,37,2414.484655407608,4,4,3,11,1
7862,193,9,4713.609627678477,3,1,5,9,2
7863,99,38,3533.740012388062,4,4,4,12,1
7864,291,49,1316.879680644369,2,5,2,9,2
7865,159,19,2524.5698705297127,3,2,3,8,2
7866,103,40,2338.697367069372,4,4,3,11,1
7867,281,7,3977.312508323035,2,1,4,7,2
7868,43,5,4168.442019340051,5,1,5,11,1
7869,84,47,1424.3796854812097,4,5,2,11,1
7870,191,42,4107.545754992119,3,5,5,13,0
7871,51,24,905.7120124020972,5,3,1,9,2
7872,210,48,3816.2250671430997,3,5,4,12,1
7873,126,41,1251.43487356879,4,5,2,11,1
7874,69,7,1496.6764754923465,5,1,2,8,2
7875,265,11,4263.81452254308,2,2,5,9,2
7876,258,9,2106.173576630922,2,1,3,6,3
7877,188,49,4952.9234660329175,3,5,5,13,0
7878,230,30,768.1957192381312,2,3,1,6,3
7879,189,41,2322.11169981802,3,5,3,11,1
7880,10,3,3664.9271512355917,5,1,4,10,1
7881,114,22,36.78161931275218,4,3,1,8,2
7882,76,40,767.7578381831567,4,4,1,9,2
7883,164,20,111.58017956079176,3,2,1,6,3
7884,85,32,4964.460548259941,4,4,5,13,0
7885,49,48,3805.517065483138,5,5,4,14,0
7886,326,7,1874.059897755535,1,1,2,4,3
7887,177,7,789.861824136911,3,1,1,5,3
7888,218,20,461.0123815892188,2,2,1,5,3
7889,189,25,2664.2169307490503,3,3,3,9,2
7890,346,45,4879.697677814002,1,5,5,11,1
7891,230,35,3376.3086138422423,2,4,4,10,1
7892,255,44,1832.04045761106,2,5,2,9,2
7893,236,24,2509.2463564550667,2,3,3,8,2
7894,26,40,4994.527806017865,5,4,5,14,0
7895,72,13,2598.643482133408,5,2,3,10,1
7896,261,48,4821.365414024015,2,5,5,12,1
7897,254,39,91.64497690095173,2,4,1,7,2
7898,271,4,3607.606009888521,2,1,4,7,2
7899,123,12,3139.5356315734516,4,2,4,10,1
7900,144,17,3429.795993702035,4,2,4,10,1
7901,257,1,2857.1297753946897,2,1,3,6,3
7902,144,17,230.44211344586262,4,2,1,7,2
7903,259,2,756.3240381042112,2,1,1,4,3
7904,47,6,4612.033838972721,5,1,5,11,1
7905,351,44,1172.2957917519118,1,5,2,8,2
7906,13,11,4964.756973941439,5,2,5,12,1
7907,208,43,3401.1465371291383,3,5,4,12,1
7908,311,18,2227.328905729661,1,2,3,6,3
7909,235,40,4601.04379361584,2,4,5,11,1
7910,149,25,3976.981086191103,3,3,4,10,1
7911,322,39,2150.535747128661,1,4,3,8,2
7912,155,28,352.27893161410674,3,3,1,7,2
7913,166,46,4342.839826927159,3,5,5,13,0
7914,90,16,3827.5492574781224,4,2,4,10,1
7915,186,12,3955.7668380806663,3,2,4,9,2
7916,318,41,3726.8450763005217,1,5,4,10,1
7917,358,29,1386.0149019966336,1,3,2,6,3
7918,174,23,4295.640141149995,3,3,5,11,1
7919,217,21,21.14044018910267,3,3,1,7,2
7920,264,16,1194.0086291349257,2,2,2,6,3
7921,97,48,242.3323981327365,4,5,1,10,1
7922,117,41,561.8763187781104,4,5,1,10,1
7923,199,45,2666.571896212352,3,5,3,11,1
7924,320,26,195.90838780576172,1,3,1,5,3
7925,21,37,915.091428024894,5,4,1,10,1
7926,200,22,1171.3733354802303,3,3,2,8,2
7927,341,10,3280.140637634736,1,1,4,6,3
7928,248,7,2349.414416996677,2,1,3,6,3
7929,276,9,2297.478490046737,2,1,3,6,3
7930,264,25,3844.478445745546,2,3,4,9,2
7931,58,46,2289.0398462509324,5,5,3,13,0
7932,302,15,1748.9588271610512,1,2,2,5,3
7933,31,13,4812.630717565621,5,2,5,12,1
7934,249,42,51.38361409490643,2,5,1,8,2
7935,93,46,1533.9110703761653,4,5,2,11,1
7936,265,26,3050.869654734818,2,3,4,9,2
7937,271,21,3916.218087903498,2,3,4,9,2
7938,94,23,4083.9006442452355,4,3,5,12,1
7939,154,44,239.90492795731066,3,5,1,9,2
7940,285,28,3548.5689572323636,2,3,4,9,2
7941,80,38,3604.065680924367,4,4,4,12,1
7942,292,12,1078.256313066778,1,2,2,5,3
7943,84,24,572.7473920657592,4,3,1,8,2
7944,37,13,3750.9339268995577,5,2,4,11,1
7945,342,40,1255.0050311240177,1,4,2,7,2
7946,327,48,18.352282377549393,1,5,1,7,2
7947,232,2,1125.6272918485365,2,1,2,5,3
7948,93,39,165.02936399339964,4,4,1,9,2
7949,336,12,1253.4415666037016,1,2,2,5,3
7950,102,39,1681.7477158357865,4,4,2,10,1
7951,166,14,1364.286796094378,3,2,2,7,2
7952,159,30,4600.48596522443,3,3,5,11,1
7953,14,41,1170.3394074525702,5,5,2,12,1
7954,225,43,2342.9987656627254,2,5,3,10,1
7955,73,48,4787.563693281794,5,5,5,15,0
7956,249,19,4397.2054619374085,2,2,5,9,2
7957,91,31,1553.1997879184792,4,4,2,10,1
7958,216,43,1639.186571837769,3,5,2,10,1
7959,90,43,2970.7137185221545,4,5,3,12,1
7960,29,25,4590.135625263607,5,3,5,13,0
7961,305,4,59.89897932445855,1,1,1,3,3
7962,220,13,1971.6677630040542,2,2,2,6,3
7963,328,36,4250.3796769474975,1,4,5,10,1
7964,215,42,2058.245192150012,3,5,3,11,1
7965,221,37,3603.0738273474963,2,4,4,10,1
7966,42,3,3462.7052630368894,5,1,4,10,1
7967,135,16,1035.2389610555326,4,2,2,8,2
7968,42,26,2253.4765767912463,5,3,3,11,1
7969,164,40,2835.271696935233,3,4,3,10,1
7970,361,39,3580.160046868008,1,4,4,9,2
7971,283,19,4113.724261559675,2,2,5,9,2
7972,58,46,3802.0667237357716,5,5,4,14,0
7973,302,15,151.2742222522985,1,2,1,4,3
7974,322,32,3356.4828295923103,1,4,4,9,2
7975,25,49,2491.604164639809,5,5,3,13,0
7976,73,21,2873.570061909398,5,3,3,11,1
7977,129,1,1871.101401601926,4,1,2,7,2
7978,87,6,3572.990810788658,4,1,4,9,2
7979,330,27,3372.703675474475,1,3,4,8,2
7980,153,23,2901.6375424672638,3,3,3,9,2
7981,182,47,4309.41160762068,3,5,5,13,0
7982,125,31,518.4811242092807,4,4,1,9,2
7983,67,12,1512.1061468422154,5,2,2,9,2
7984,6,21,2480.700771862111,5,3,3,11,1
7985,125,2,4793.438008384682,4,1,5,10,1
7986,314,5,369.0972975462778,1,1,1,3,3
7987,326,9,1692.0166750243372,1,1,2,4,3
7988,53,20,4630.19386309249,5,2,5,12,1
7989,66,46,4490.758361571325,5,5,5,15,0
7990,314,18,4327.575397830936,1,2,5,8,2
7991,82,22,1548.8683754469057,4,3,2,9,2
7992,87,8,4235.710540957517,4,1,5,10,1
7993,2,34,2531.6436653606343,5,4,3,12,1
7994,204,9,3102.6964317713882,3,1,4,8,2
7995,150,7,1201.7362782497369,3,1,2,6,3
7996,293,30,3536.3027057063146,1,3,4,8,2
7997,103,18,1645.20855023564,4,2,2,8,2
7998,24,27,1725.963326342051,5,3,2,10,1
7999,212,16,3187.7177087069417,3,2,4,9,2
8000,65,21,1206.7612916486137,5,3,2,10,1
8001,209,5,1129.949228996625,3,1,2,6,3
8002,251,29,1852.1230835544268,2,3,2,7,2
8003,117,47,3892.5374890455755,4,5,4,13,0
8004,116,37,1131.1634248251148,4,4,2,10,1
8005,237,43,3938.7187688627287,2,5,4,11,1
8006,105,22,3481.0703330521023,4,3,4,11,1
8007,259,14,3398.6086035460457,2,2,4,8,2
8008,46,19,2379.0308118299185,5,2,3,10,1
8009,311,35,3731.980288463162,1,4,4,9,2
8010,331,24,77.46240531835633,1,3,1,5,3
8011,216,42,1534.9802182454553,3,5,2,10,1
8012,301,6,3398.8959444808343,1,1,4,6,3
8013,333,3,4936.60416708376,1,1,5,7,2
8014,24,34,22.546562010536995,5,4,1,10,1
8015,35,45,2554.7616025182024,5,5,3,13,0
8016,24,2,4619.943780894751,5,1,5,11,1
8017,28,15,4319.061530235202,5,2,5,12,1
8018,16,37,125.44961182456285,5,4,1,10,1
8019,59,15,2652.4950554799193,5,2,3,10,1
8020,243,32,31.392636070498458,2,4,1,7,2
8021,207,21,3949.978991679554,3,3,4,10,1
8022,271,17,1551.2854620258354,2,2,2,6,3
8023,249,34,3830.29740295729,2,4,4,10,1
8024,267,32,4724.518775100823,2,4,5,11,1
8025,193,47,4880.66442023419,3,5,5,13,0
8026,335,23,4471.614792581916,1,3,5,9,2
8027,218,35,1028.6758313430812,2,4,2,8,2
8028,115,37,981.0548479407045,4,4,1,9,2
8029,68,43,3132.6443601022766,5,5,4,14,0
8030,299,41,2724.827874417399,1,5,3,9,2
8031,325,37,57.577692928730755,1,4,1,6,3
8032,75,33,1964.7194822451327,4,4,2,10,1
8033,103,25,4534.388117530705,4,3,5,12,1
8034,297,46,4492.811504410111,1,5,5,11,1
8035,178,37,1027.4953516392138,3,4,2,9,2
8036,215,40,1915.9957150947312,3,4,2,9,2
8037,315,21,2806.226394870452,1,3,3,7,2
8038,39,46,4265.3934828102,5,5,5,15,0
8039,259,48,2664.652251814328,2,5,3,10,1
8040,204,38,4841.317064190544,3,4,5,12,1
8041,7,40,3997.270168559561,5,4,4,13,0
8042,49,34,4765.928446163323,5,4,5,14,0
8043,26,19,3660.1461696979527,5,2,4,11,1
8044,161,27,4389.344455419025,3,3,5,11,1
8045,357,9,4156.708923965469,1,1,5,7,2
8046,176,5,1276.6540238882287,3,1,2,6,3
8047,79,5,1155.3867530368009,4,1,2,7,2
8048,2,25,4323.27329302909,5,3,5,13,0
8049,132,26,432.5419102264114,4,3,1,8,2
8050,276,19,2048.732387451662,2,2,3,7,2
8051,117,30,4105.08227372494,4,3,5,12,1
8052,164,36,4068.0642658874563,3,4,5,12,1
8053,288,48,702.526225294545,2,5,1,8,2
8054,28,48,2443.671906277475,5,5,3,13,0
8055,333,16,2404.3636895984027,1,2,3,6,3
8056,1,7,1625.3700476717001,5,1,2,8,2
8057,188,18,4586.73391387104,3,2,5,10,1
8058,56,21,3269.056883908602,5,3,4,12,1
8059,35,31,4901.135574323409,5,4,5,14,0
8060,112,1,343.1633920255265,4,1,1,6,3
8061,286,3,1977.8073628255495,2,1,2,5,3
8062,310,31,4177.336434873065,1,4,5,10,1
8063,36,25,2119.2014893686746,5,3,3,11,1
8064,217,8,1316.7713549461878,3,1,2,6,3
8065,80,1,4989.059646142365,4,1,5,10,1
8066,314,7,4366.893199614546,1,1,5,7,2
8067,83,7,2736.903569884248,4,1,3,8,2
8068,65,8,2812.9290888705714,5,1,3,9,2
8069,325,19,44.24617333238963,1,2,1,4,3
8070,128,17,4905.162958606728,4,2,5,11,1
8071,307,11,4033.412857918383,1,2,5,8,2
8072,22,47,193.279504127698,5,5,1,11,1
8073,216,41,889.8876588741907,3,5,1,9,2
8074,107,49,4106.94583918415,4,5,5,14,0
8075,109,11,443.45908587708385,4,2,1,7,2
8076,357,38,4709.51078027274,1,4,5,10,1
8077,181,41,4999.456400131619,3,5,5,13,0
8078,356,2,4433.299719805658,1,1,5,7,2
8079,164,4,3697.1309068940086,3,1,4,8,2
8080,68,28,2441.538932332178,5,3,3,11,1
8081,292,33,421.32358597339413,1,4,1,6,3
8082,180,11,3654.9266968925876,3,2,4,9,2
8083,181,3,1990.3571185991534,3,1,2,6,3
8084,169,40,2855.4408694219055,3,4,3,10,1
8085,22,5,1474.0184759467245,5,1,2,8,2
8086,66,21,1218.35848747856,5,3,2,10,1
8087,21,22,1628.2418236455608,5,3,2,10,1
8088,100,37,4071.0018368344276,4,4,5,13,0
8089,300,11,2138.192785396204,1,2,3,6,3
8090,103,44,1565.4224806931156,4,5,2,11,1
8091,47,22,2170.5222824018547,5,3,3,11,1
8092,39,41,171.11395607287685,5,5,1,11,1
8093,285,13,4454.115371248762,2,2,5,9,2
8094,310,3,2763.2901802427227,1,1,3,5,3
8095,90,13,533.082873332119,4,2,1,7,2
8096,85,28,1449.1505904261849,4,3,2,9,2
8097,273,11,4917.928216900095,2,2,5,9,2
8098,336,11,2969.3565577555764,1,2,3,6,3
8099,188,21,1464.1103856302288,3,3,2,8,2
8100,159,21,2137.464850216311,3,3,3,9,2
8101,243,7,1299.7891493823213,2,1,2,5,3
8102,73,17,168.7032430265026,5,2,1,8,2
8103,49,48,4211.72986043875,5,5,5,15,0
8104,101,14,1469.4684221229,4,2,2,8,2
8105,2,33,4193.66958688651,5,4,5,14,0
8106,244,11,2397.999762902478,2,2,3,7,2
8107,176,13,922.6442383686597,3,2,1,6,3
8108,238,1,4011.3247790912465,2,1,4,7,2
8109,59,34,1891.7862904684146,5,4,2,11,1
8110,353,9,3541.5686471550357,1,1,4,6,3
8111,99,13,4187.776048453375,4,2,5,11,1
8112,359,37,4815.29842515583,1,4,5,10,1
8113,2,30,438.2145176053473,5,3,1,9,2
8114,243,41,51.84854438378229,2,5,1,8,2
8115,297,45,2746.640657797013,1,5,3,9,2
8116,211,37,1328.5623997562507,3,4,2,9,2
8117,123,47,2350.817930820446,4,5,3,12,1
8118,229,7,372.5668489089762,2,1,1,4,3
8119,82,14,2512.929342900065,4,2,3,9,2
8120,144,48,633.0297093589206,4,5,1,10,1
8121,140,6,4194.552913413266,4,1,5,10,1
8122,29,34,3799.839145155919,5,4,4,13,0
8123,270,16,379.6271553040383,2,2,1,5,3
8124,247,37,4183.388270092391,2,4,5,11,1
8125,12,36,1631.5428771988668,5,4,2,11,1
8126,355,46,1770.7701169578813,1,5,2,8,2
8127,337,6,907.2198354653922,1,1,1,3,3
8128,106,8,4178.167566247465,4,1,5,10,1
8129,32,24,2029.4817616036398,5,3,3,11,1
8130,74,3,253.69099469476535,4,1,1,6,3
8131,171,4,4831.585642852553,3,1,5,9,2
8132,337,32,1286.8771976647024,1,4,2,7,2
8133,69,1,4681.524616753295,5,1,5,11,1
8134,301,34,1513.179429607335,1,4,2,7,2
8135,362,45,4158.818707543589,1,5,5,11,1
8136,137,9,3324.455267371362,4,1,4,9,2
8137,100,12,4307.804325627928,4,2,5,11,1
8138,146,10,4880.828753647457,4,1,5,10,1
8139,9,10,4358.703580448498,5,1,5,11,1
8140,62,44,2024.2891558851024,5,5,3,13,0
8141,185,48,4074.372372660862,3,5,5,13,0
8142,29,23,3561.1375434323945,5,3,4,12,1
8143,114,6,317.40231744995054,4,1,1,6,3
8144,143,24,4649.502887710744,4,3,5,12,1
8145,120,24,2335.1458472178874,4,3,3,10,1
8146,170,21,680.908322824317,3,3,1,7,2
8147,157,42,2132.6367050187487,3,5,3,11,1
8148,335,31,3019.6748131561726,1,4,3,8,2
8149,349,47,2869.0011641687092,1,5,3,9,2
8150,260,41,2878.2202974636516,2,5,3,10,1
8151,82,30,1286.638022927151,4,3,2,9,2
8152,242,34,3167.185222611733,2,4,4,10,1
8153,172,18,4538.000020550537,3,2,5,10,1
8154,231,12,1949.4480632924876,2,2,2,6,3
8155,208,35,3156.595610274348,3,4,4,11,1
8156,75,7,1227.4951649661584,4,1,2,7,2
8157,270,41,250.9222907416222,2,5,1,8,2
8158,114,40,2932.7995059578316,4,4,3,11,1
8159,62,25,247.27351290427706,5,3,1,9,2
8160,362,6,3620.687128653162,1,1,4,6,3
8161,320,1,3355.059962030803,1,1,4,6,3
8162,102,46,1852.931844317564,4,5,2,11,1
8163,362,16,2062.3376471434294,1,2,3,6,3
8164,210,48,4589.627073021727,3,5,5,13,0
8165,255,4,75.53679136008309,2,1,1,4,3
8166,20,29,2820.8838703067304,5,3,3,11,1
8167,58,38,4617.572017414972,5,4,5,14,0
8168,112,47,4570.796366370288,4,5,5,14,0
8169,313,28,2927.432261485216,1,3,3,7,2
8170,196,22,1912.3376945588939,3,3,2,8,2
8171,353,8,503.52859639854614,1,1,1,3,3
8172,92,32,877.1831770236289,4,4,1,9,2
8173,52,33,3401.5700424662705,5,4,4,13,0
8174,293,13,93.00407821074147,1,2,1,4,3
8175,8,27,4418.593026275833,5,3,5,13,0
8176,300,18,2943.7930060279587,1,2,3,6,3
8177,98,18,235.28184470117316,4,2,1,7,2
8178,236,13,1206.4394267562463,2,2,2,6,3
8179,69,22,2975.0625437325966,5,3,3,11,1
8180,45,14,187.65031464447748,5,2,1,8,2
8181,137,11,3902.1371357692337,4,2,4,10,1
8182,234,39,4600.41111348471,2,4,5,11,1
8183,32,22,4806.489762576667,5,3,5,13,0
8184,289,36,3670.9596420336206,2,4,4,10,1
8185,126,17,4285.55909948919,4,2,5,11,1
8186,67,32,3057.4302370253845,5,4,4,13,0
8187,30,14,2298.1328860624567,5,2,3,10,1
8188,114,42,3568.542419327314,4,5,4,13,0
8189,204,29,1128.6615146708482,3,3,2,8,2
8190,29,6,557.8237877157957,5,1,1,7,2
8191,131,4,3811.636370883204,4,1,4,9,2
8192,185,11,4791.352096999486,3,2,5,10,1
8193,253,45,2891.621868316837,2,5,3,10,1
8194,286,40,2417.886431279323,2,4,3,9,2
8195,62,10,2676.6771140482006,5,1,3,9,2
8196,3,28,2397.536280080314,5,3,3,11,1
8197,68,11,2216.5794030744187,5,2,3,10,1
8198,25,35,4735.708113789602,5,4,5,14,0
8199,179,15,2404.0183237299593,3,2,3,8,2
8200,141,8,414.70118065975305,4,1,1,6,3
8201,231,20,3829.92822856048,2,2,4,8,2
8202,300,21,1963.8924010054943,1,3,2,6,3
8203,163,1,3556.3607932869295,3,1,4,8,2
8204,311,29,2902.0511042762896,1,3,3,7,2
8205,130,24,3568.768525127694,4,3,4,11,1
8206,246,30,319.349845608041,2,3,1,6,3
8207,297,40,179.02788011243706,1,4,1,6,3
8208,172,35,1898.9227080071944,3,4,2,9,2
8209,64,33,3468.8990277314847,5,4,4,13,0
8210,31,20,1126.1758092609107,5,2,2,9,2
8211,47,16,2172.6695826332348,5,2,3,10,1
8212,130,9,4904.243217225143,4,1,5,10,1
8213,352,31,1082.224027041554,1,4,2,7,2
8214,333,17,4241.237874239105,1,2,5,8,2
8215,110,31,4129.049815207871,4,4,5,13,0
8216,69,48,4457.847404592052,5,5,5,15,0
8217,58,23,4576.557300707648,5,3,5,13,0
8218,106,6,2541.5277600666795,4,1,3,8,2
8219,300,30,3412.849578145923,1,3,4,8,2
8220,330,7,3098.265650958315,1,1,4,6,3
8221,256,48,1551.6532164241294,2,5,2,9,2
8222,312,40,1406.1400549119896,1,4,2,7,2
8223,171,42,1714.4341478104457,3,5,2,10,1
8224,162,46,1100.1040827183838,3,5,2,10,1
8225,286,11,3789.3439169590497,2,2,4,8,2
8226,71,34,4823.218613448314,5,4,5,14,0
8227,255,12,4340.18099177201,2,2,5,9,2
8228,55,45,1097.522616401019,5,5,2,12,1
8229,323,47,269.05819885377736,1,5,1,7,2
8230,3,27,3787.8985962901534,5,3,4,12,1
8231,26,12,1957.166891483995,5,2,2,9,2
8232,313,13,4124.816954671907,1,2,5,8,2
8233,126,8,3898.386624966396,4,1,4,9,2
8234,53,16,3130.797157475048,5,2,4,11,1
8235,198,29,1284.1432785531829,3,3,2,8,2
8236,299,35,529.1384814724336,1,4,1,6,3
8237,188,29,1270.7151470201145,3,3,2,8,2
8238,186,31,2553.7008797738813,3,4,3,10,1
8239,305,13,4897.520248455487,1,2,5,8,2
8240,298,12,327.7993285997897,1,2,1,4,3
8241,204,2,1008.3592840714997,3,1,1,5,3
8242,11,33,3140.124493885202,5,4,4,13,0
8243,359,8,1528.7783293884681,1,1,2,4,3
8244,354,41,4293.9364542050225,1,5,5,11,1
8245,146,40,705.6907654573191,4,4,1,9,2
8246,85,49,4816.156042683868,4,5,5,14,0
8247,100,41,4562.750708667469,4,5,5,14,0
8248,104,32,4438.7699894934985,4,4,5,13,0
8249,46,38,873.6145183994463,5,4,1,10,1
8250,44,28,1654.185660020695,5,3,2,10,1
8251,278,15,4022.4432427453016,2,2,5,9,2
8252,181,23,4040.962247144131,3,3,5,11,1
8253,187,24,3528.8253218835903,3,3,4,10,1
8254,114,13,2245.773898853421,4,2,3,9,2
8255,255,21,1564.830460660451,2,3,2,7,2
8256,30,12,4815.160101546819,5,2,5,12,1
8257,264,13,704.9187267428465,2,2,1,5,3
8258,98,39,228.332764200161,4,4,1,9,2
8259,313,23,55.5612947494071,1,3,1,5,3
8260,329,46,3877.3842790721055,1,5,4,10,1
8261,115,43,292.95867837403,4,5,1,10,1
8262,276,28,2697.8315863148414,2,3,3,8,2
8263,281,14,1842.789280925839,2,2,2,6,3
8264,275,17,743.0703714603127,2,2,1,5,3
8265,261,24,3705.5714795671433,2,3,4,9,2
8266,331,34,284.48408690923344,1,4,1,6,3
8267,207,48,1598.785254541407,3,5,2,10,1
8268,328,22,2815.3342148462543,1,3,3,7,2
8269,211,10,2018.0544595476986,3,1,3,7,2
8270,215,8,1303.1495113094086,3,1,2,6,3
8271,40,21,4630.745013483173,5,3,5,13,0
8272,26,37,4655.542238608334,5,4,5,14,0
8273,27,7,2086.3117526500396,5,1,3,9,2
8274,190,26,1974.7846396394855,3,3,2,8,2
8275,83,13,1543.8513869586377,4,2,2,8,2
8276,170,16,4280.223402632679,3,2,5,10,1
8277,167,30,2843.8972771145727,3,3,3,9,2
8278,188,31,456.7158423832515,3,4,1,8,2
8279,169,5,4268.070308560654,3,1,5,9,2
8280,289,32,2679.0824870854335,2,4,3,9,2
8281,229,16,2083.803102488483,2,2,3,7,2
8282,97,47,1695.946068781354,4,5,2,11,1
8283,16,9,506.13868566159493,5,1,1,7,2
8284,279,22,4783.943760440338,2,3,5,10,1
8285,135,44,3708.805152186785,4,5,4,13,0
8286,26,40,667.5700398639137,5,4,1,10,1
8287,352,45,2561.231407482823,1,5,3,9,2
8288,12,37,2782.320236953572,5,4,3,12,1
8289,72,14,847.7648975834713,5,2,1,8,2
8290,133,16,2141.8354290228967,4,2,3,9,2
8291,106,43,3232.2731161154998,4,5,4,13,0
8292,220,20,1427.212753355653,2,2,2,6,3
8293,177,44,1664.7286849008422,3,5,2,10,1
8294,282,15,618.9221005543903,2,2,1,5,3
8295,133,44,2072.0708151855233,4,5,3,12,1
8296,22,26,2923.4478506943906,5,3,3,11,1
8297,269,9,591.4624480895917,2,1,1,4,3
8298,161,1,3077.7739505868276,3,1,4,8,2
8299,107,35,1994.9881416165338,4,4,2,10,1
8300,279,44,3394.1294494101326,2,5,4,11,1
8301,353,20,1581.0365078289617,1,2,2,5,3
8302,235,45,2846.8111990751045,2,5,3,10,1
8303,18,6,3067.8862128164087,5,1,4,10,1
8304,242,42,3455.631921739262,2,5,4,11,1
8305,117,10,3787.1255278511235,4,1,4,9,2
8306,286,48,690.3950324005408,2,5,1,8,2
8307,282,33,4826.5612835793845,2,4,5,11,1
8308,144,16,4219.790624112272,4,2,5,11,1
8309,205,36,2815.9707251670998,3,4,3,10,1
8310,39,6,4452.890765184006,5,1,5,11,1
8311,154,19,1918.3405102239392,3,2,2,7,2
8312,176,31,181.08989251460605,3,4,1,8,2
8313,241,2,3637.886590531036,2,1,4,7,2
8314,134,18,4717.2873052832465,4,2,5,11,1
8315,46,42,817.6547712407586,5,5,1,11,1
8316,50,28,3222.930995611514,5,3,4,12,1
8317,166,4,4068.9935476550613,3,1,5,9,2
8318,106,1,4526.284587674034,4,1,5,10,1
8319,216,47,1389.8735179847781,3,5,2,10,1
8320,146,42,652.3817088298105,4,5,1,10,1
8321,72,16,1246.7720682409147,5,2,2,9,2
8322,330,45,2892.830988685487,1,5,3,9,2
8323,273,47,4594.453999912703,2,5,5,12,1
8324,247,2,2916.853697880546,2,1,3,6,3
8325,186,36,4598.910291171623,3,4,5,12,1
8326,70,1,3852.484748219183,5,1,4,10,1
8327,150,39,2995.9634261973683,3,4,3,10,1
8328,246,23,118.77456122401472,2,3,1,6,3
8329,262,26,1672.0480817019447,2,3,2,7,2
8330,26,11,296.72319055228223,5,2,1,8,2
8331,140,42,1617.9893278674015,4,5,2,11,1
8332,99,1,321.0441558106196,4,1,1,6,3
8333,278,11,847.4011486358116,2,2,1,5,3
8334,51,24,2059.3227220496206,5,3,3,11,1
8335,151,10,2579.2748797105737,3,1,3,7,2
8336,104,14,1093.5370245813458,4,2,2,8,2
8337,89,14,3665.561122497365,4,2,4,10,1
8338,141,7,2955.9194631164287,4,1,3,8,2
8339,213,23,3461.8850485087564,3,3,4,10,1
8340,233,43,3666.500748656132,2,5,4,11,1
8341,183,22,3637.3324895193077,3,3,4,10,1
8342,251,36,4681.807166972296,2,4,5,11,1
8343,9,27,1193.7294662341883,5,3,2,10,1
8344,79,2,1358.0766397640282,4,1,2,7,2
8345,52,39,480.06332933073185,5,4,1,10,1
8346,269,46,2967.0059235812046,2,5,3,10,1
8347,226,19,1981.9756831129484,2,2,2,6,3
8348,51,7,2486.0324145321365,5,1,3,9,2
8349,186,12,857.4090739935576,3,2,1,6,3
8350,34,3,3248.8106503512013,5,1,4,10,1
8351,291,47,3098.9066095908615,2,5,4,11,1
8352,230,5,1331.2742903907774,2,1,2,5,3
8353,131,8,2332.4292852261096,4,1,3,8,2
8354,120,14,4472.5616811553255,4,2,5,11,1
8355,326,36,3869.760181285735,1,4,4,9,2
8356,247,7,1142.4499450490252,2,1,2,5,3
8357,192,7,4395.485713973021,3,1,5,9,2
8358,323,46,345.89173737349887,1,5,1,7,2
8359,210,32,2075.5035446165075,3,4,3,10,1
8360,103,8,409.78995541160634,4,1,1,6,3
8361,329,12,4621.828828990578,1,2,5,8,2
8362,133,10,213.1051846820163,4,1,1,6,3
8363,323,14,764.6890775784809,1,2,1,4,3
8364,139,9,4576.04931974439,4,1,5,10,1
8365,121,38,2914.96664805414,4,4,3,11,1
8366,94,30,3977.987995730367,4,3,4,11,1
8367,129,5,91.86973370635758,4,1,1,6,3
8368,91,1,2101.284402071033,4,1,3,8,2
8369,92,1,4922.483495068661,4,1,5,10,1
8370,63,20,2903.297139490478,5,2,3,10,1
8371,29,49,4249.917115113594,5,5,5,15,0
8372,210,11,4818.161789715425,3,2,5,10,1
8373,12,26,3428.352140021809,5,3,4,12,1
8374,333,44,1644.876003848972,1,5,2,8,2
8375,297,3,1549.9486020129577,1,1,2,4,3
8376,130,6,365.67426530357517,4,1,1,6,3
8377,293,43,2144.5827890104365,1,5,3,9,2
8378,173,45,4577.793183953184,3,5,5,13,0
8379,208,11,2395.531508703964,3,2,3,8,2
8380,24,8,4555.864601532637,5,1,5,11,1
8381,99,29,4087.5382468089124,4,3,5,12,1
8382,356,10,4921.093695316834,1,1,5,7,2
8383,139,34,4738.999456641395,4,4,5,13,0
8384,314,24,3535.3515125744184,1,3,4,8,2
8385,174,46,4357.374261511115,3,5,5,13,0
8386,29,48,3742.9077311455544,5,5,4,14,0
8387,143,17,3519.938628064667,4,2,4,10,1
8388,316,32,3580.6422937100333,1,4,4,9,2
8389,351,11,3608.00794003623,1,2,4,7,2
8390,42,34,1903.3008691891268,5,4,2,11,1
8391,299,24,2123.576456102395,1,3,3,7,2
8392,208,5,1477.415084273491,3,1,2,6,3
8393,330,29,749.8202725999339,1,3,1,5,3
8394,192,48,2297.63256766762,3,5,3,11,1
8395,160,48,4500.746953468691,3,5,5,13,0
8396,64,34,3259.810886022966,5,4,4,13,0
8397,243,16,290.3399949933749,2,2,1,5,3
8398,258,25,4057.887723377614,2,3,5,10,1
8399,152,37,4677.653620815327,3,4,5,12,1
8400,215,8,4148.817975533985,3,1,5,9,2
8401,322,29,3640.431656637177,1,3,4,8,2
8402,166,46,759.1007751084742,3,5,1,9,2
8403,31,25,1751.5094623404145,5,3,2,10,1
8404,232,42,2830.781572856671,2,5,3,10,1
8405,282,23,393.5352890981638,2,3,1,6,3
8406,29,34,540.2883685375664,5,4,1,10,1
8407,195,3,4671.927070835638,3,1,5,9,2
8408,334,30,3516.4290544471583,1,3,4,8,2
8409,256,34,1382.684359795865,2,4,2,8,2
8410,281,32,1643.5279457091253,2,4,2,8,2
8411,304,29,1928.3022283580453,1,3,2,6,3
8412,321,9,384.6057499677974,1,1,1,3,3
8413,323,2,3698.493223584996,1,1,4,6,3
8414,346,39,892.4017203351161,1,4,1,6,3
8415,294,7,4027.548923855343,1,1,5,7,2
8416,87,46,4230.903424586899,4,5,5,14,0
8417,149,5,3195.786545363046,3,1,4,8,2
8418,249,8,3851.576167560577,2,1,4,7,2
8419,321,32,867.4574817633564,1,4,1,6,3
8420,283,18,2883.9355235264775,2,2,3,7,2
8421,362,38,3387.228579086195,1,4,4,9,2
8422,198,46,3311.1872984628462,3,5,4,12,1
8423,44,18,595.276489439472,5,2,1,8,2
8424,356,49,1728.4684877753903,1,5,2,8,2
8425,28,41,1631.9372321968594,5,5,2,12,1
8426,17,45,2866.9090942585726,5,5,3,13,0
8427,127,16,3828.5332730500886,4,2,4,10,1
8428,168,21,2857.2459271893667,3,3,3,9,2
8429,244,10,3776.5889188717547,2,1,4,7,2
8430,76,42,503.8483075280505,4,5,1,10,1
8431,231,4,4391.912067427714,2,1,5,8,2
8432,204,44,2687.719176127656,3,5,3,11,1
8433,248,8,197.11831573119264,2,1,1,4,3
8434,302,47,3219.6328850819073,1,5,4,10,1
8435,214,19,2591.562464941747,3,2,3,8,2
8436,215,47,1109.6441485543392,3,5,2,10,1
8437,158,40,3824.4830384706597,3,4,4,11,1
8438,69,40,4668.50557352782,5,4,5,14,0
8439,85,9,1620.190434679094,4,1,2,7,2
8440,267,30,2474.639257253681,2,3,3,8,2
8441,69,17,649.5932435051611,5,2,1,8,2
8442,99,40,4649.700621287033,4,4,5,13,0
8443,347,44,1600.7923374999725,1,5,2,8,2
8444,216,15,981.9755716606339,3,2,1,6,3
8445,161,4,2397.3590970795826,3,1,3,7,2
8446,94,6,225.9796226108919,4,1,1,6,3
8447,174,16,1271.6557878197602,3,2,2,7,2
8448,165,26,347.61210509214004,3,3,1,7,2
8449,115,37,645.5820609260569,4,4,1,9,2
8450,220,23,569.6661788206818,2,3,1,6,3
8451,31,13,4363.375575539607,5,2,5,12,1
8452,11,47,4652.869891692793,5,5,5,15,0
8453,343,17,2377.865607242929,1,2,3,6,3
8454,130,27,3155.781268388193,4,3,4,11,1
8455,105,22,3482.5504673423625,4,3,4,11,1
8456,27,37,1962.6534911115803,5,4,2,11,1
8457,227,19,1857.3502305440104,2,2,2,6,3
8458,2,39,3381.0894059261113,5,4,4,13,0
8459,359,35,1889.80543107374,1,4,2,7,2
8460,101,13,2909.237502555384,4,2,3,9,2
8461,21,14,2580.812125949174,5,2,3,10,1
8462,58,48,2627.0583984958976,5,5,3,13,0
8463,180,31,4148.500725753491,3,4,5,12,1
8464,341,45,3523.244973404496,1,5,4,10,1
8465,349,2,4803.806443650084,1,1,5,7,2
8466,20,46,3956.9733699853823,5,5,4,14,0
8467,255,39,737.5046478534797,2,4,1,7,2
8468,317,37,3695.0316819692152,1,4,4,9,2
8469,38,14,3331.5812942960056,5,2,4,11,1
8470,148,9,3233.759457761629,3,1,4,8,2
8471,25,10,2408.915684698098,5,1,3,9,2
8472,121,7,321.69495988177226,4,1,1,6,3
8473,26,28,4757.908989875248,5,3,5,13,0
8474,169,46,4261.104226674815,3,5,5,13,0
8475,323,25,2439.1721066851715,1,3,3,7,2
8476,225,46,801.319028477734,2,5,1,8,2
8477,1,28,4124.118562700236,5,3,5,13,0
8478,307,2,2159.051310991837,1,1,3,5,3
8479,261,17,1956.6684782967336,2,2,2,6,3
8480,13,4,3330.25733734418,5,1,4,10,1
8481,48,13,3795.790238677931,5,2,4,11,1
8482,313,18,323.5752757360858,1,2,1,4,3
8483,291,3,3840.1065182527295,2,1,4,7,2
8484,332,37,3672.3631017446246,1,4,4,9,2
8485,94,33,2950.1559565049974,4,4,3,11,1
8486,261,41,1698.7103826470902,2,5,2,9,2
8487,278,24,832.362714806581,2,3,1,6,3
8488,359,8,522.2383162274775,1,1,1,3,3
8489,205,35,15.906631655654163,3,4,1,8,2
8490,185,2,1040.2362767035434,3,1,2,6,3
8491,175,33,2062.571480549365,3,4,3,10,1
8492,309,12,1225.7852136864208,1,2,2,5,3
8493,69,22,1551.8054774889993,5,3,2,10,1
8494,104,13,1958.357552651341,4,2,2,8,2
8495,246,10,1548.2289192425012,2,1,2,5,3
8496,161,17,3625.8589829070665,3,2,4,9,2
8497,200,43,2463.7166779332,3,5,3,11,1
8498,216,5,106.44246728268307,3,1,1,5,3
8499,212,9,1141.074474497894,3,1,2,6,3
8500,16,13,3551.1946407263085,5,2,4,11,1
8501,332,23,1511.6433112010614,1,3,2,6,3
8502,205,30,4601.507440778254,3,3,5,11,1
8503,39,43,3566.193596762629,5,5,4,14,0
8504,89,4,1456.7356096394103,4,1,2,7,2
8505,256,21,2586.8851324054863,2,3,3,8,2
8506,254,43,3339.5227605990467,2,5,4,11,1
8507,216,9,974.8956680321056,3,1,1,5,3
8508,303,7,1238.4754647554428,1,1,2,4,3
8509,172,16,2540.5474918526597,3,2,3,8,2
8510,137,23,4625.224665226558,4,3,5,12,1
8511,178,23,1726.6117306195,3,3,2,8,2
8512,77,31,2016.6303372225254,4,4,3,11,1
8513,188,5,961.1948513007528,3,1,1,5,3
8514,15,6,2970.111389412816,5,1,3,9,2
8515,292,1,3703.352228782482,1,1,4,6,3
8516,319,48,2208.804908885006,1,5,3,9,2
8517,325,28,3753.744404502494,1,3,4,8,2
8518,214,18,1519.9975696061074,3,2,2,7,2
8519,208,24,3537.8522459622222,3,3,4,10,1
8520,169,13,1299.1392205205661,3,2,2,7,2
8521,330,33,3905.4412134401355,1,4,4,9,2
8522,280,10,4154.901475713055,2,1,5,8,2
8523,305,7,3990.6411051153464,1,1,4,6,3
8524,146,37,1085.2083031946238,4,4,2,10,1
8525,263,32,3474.3046950907546,2,4,4,10,1
8526,4,45,2697.316533007983,5,5,3,13,0
8527,90,22,4930.324580045348,4,3,5,12,1
8528,60,16,1814.2683366855297,5,2,2,9,2
8529,311,24,3858.5442506668123,1,3,4,8,2
8530,16,14,1856.6898041160116,5,2,2,9,2
8531,227,11,1990.3187960286693,2,2,2,6,3
8532,29,19,563.851000181436,5,2,1,8,2
8533,151,23,1205.9093172726948,3,3,2,8,2
8534,245,34,830.7765899959613,2,4,1,7,2
8535,270,40,804.4107996091963,2,4,1,7,2
8536,79,13,54.992472982762045,4,2,1,7,2
8537,289,39,3970.966039669084,2,4,4,10,1
8538,153,44,2344.9767775190076,3,5,3,11,1
8539,277,28,4022.7961641241823,2,3,5,10,1
8540,279,40,3066.6265419020365,2,4,4,10,1
8541,57,16,4158.374935777742,5,2,5,12,1
8542,186,28,2523.787366154831,3,3,3,9,2
8543,93,4,479.2646954827842,4,1,1,6,3
8544,276,28,3087.650579737364,2,3,4,9,2
8545,158,12,3392.046662691073,3,2,4,9,2
8546,275,16,3136.2557998222646,2,2,4,8,2
8547,181,49,4008.668212980633,3,5,4,12,1
8548,359,36,3660.1812275910042,1,4,4,9,2
8549,77,20,2168.835921502357,4,2,3,9,2
8550,151,26,4097.327240721665,3,3,5,11,1
8551,238,26,3462.0148452920125,2,3,4,9,2
8552,289,22,610.6300251899049,2,3,1,6,3
8553,231,9,2703.9658480946005,2,1,3,6,3
8554,18,5,3645.4934730873924,5,1,4,10,1
8555,73,17,2770.9081265742193,5,2,3,10,1
8556,189,49,4745.6529682484725,3,5,5,13,0
8557,17,34,516.4414283617599,5,4,1,10,1
8558,19,2,3614.38524746535,5,1,4,10,1
8559,219,7,4124.009549033208,2,1,5,8,2
8560,326,36,3516.2394425768093,1,4,4,9,2
8561,120,13,1934.0691752713874,4,2,2,8,2
8562,101,20,1933.5467628845968,4,2,2,8,2
8563,34,30,2936.971850324313,5,3,3,11,1
8564,84,30,1991.5192014090876,4,3,2,9,2
8565,196,11,4417.083156855497,3,2,5,10,1
8566,330,31,558.5537852893075,1,4,1,6,3
8567,202,3,3199.395166384035,3,1,4,8,2
8568,344,2,679.2336542604522,1,1,1,3,3
8569,341,48,2705.3974144702183,1,5,3,9,2
8570,11,3,3580.750200029368,5,1,4,10,1
8571,347,15,835.8994736356424,1,2,1,4,3
8572,218,17,3523.1257752333704,2,2,4,8,2
8573,253,48,708.5003557433437,2,5,1,8,2
8574,222,7,3106.5631906894037,2,1,4,7,2
8575,80,48,2532.709616321199,4,5,3,12,1
8576,7,5,1497.3940195082155,5,1,2,8,2
8577,272,34,566.6281669679594,2,4,1,7,2
8578,227,33,3681.9121566085732,2,4,4,10,1
8579,16,45,1915.2076155512598,5,5,2,12,1
8580,12,16,441.7885785931501,5,2,1,8,2
8581,291,37,3866.218797980937,2,4,4,10,1
8582,241,3,1172.1444705842653,2,1,2,5,3
8583,21,47,3684.895747990547,5,5,4,14,0
8584,178,48,2828.844442844276,3,5,3,11,1
8585,228,43,980.6997677794656,2,5,1,8,2
8586,273,21,391.26457860221205,2,3,1,6,3
8587,288,41,2970.3125868591023,2,5,3,10,1
8588,297,8,135.8070428747497,1,1,1,3,3
8589,134,22,336.667779471923,4,3,1,8,2
8590,283,5,3514.073219013836,2,1,4,7,2
8591,153,17,2698.980468592503,3,2,3,8,2
8592,66,37,1638.213375615341,5,4,2,11,1
8593,137,14,2700.747433915434,4,2,3,9,2
8594,92,39,2962.3301443493483,4,4,3,11,1
8595,317,41,2830.776472559887,1,5,3,9,2
8596,259,28,3216.3445174622975,2,3,4,9,2
8597,103,31,4702.037619949932,4,4,5,13,0
8598,55,17,1949.999825219287,5,2,2,9,2
8599,257,35,1512.7455531533049,2,4,2,8,2
8600,101,40,201.79020604054688,4,4,1,9,2
8601,198,22,743.8945537152666,3,3,1,7,2
8602,301,45,540.1865812469019,1,5,1,7,2
8603,226,48,1683.8664924935865,2,5,2,9,2
8604,237,29,3053.8537367871268,2,3,4,9,2
8605,26,10,241.20611676157125,5,1,1,7,2
8606,121,18,3641.0483722288773,4,2,4,10,1
8607,182,35,1993.190420388919,3,4,2,9,2
8608,199,44,4817.887533784388,3,5,5,13,0
8609,302,16,2846.2410262077738,1,2,3,6,3
8610,255,49,3859.097938818559,2,5,4,11,1
8611,122,7,4307.2943491621945,4,1,5,10,1
8612,31,30,4445.343043614382,5,3,5,13,0
8613,315,19,2597.124130902238,1,2,3,6,3
8614,285,23,1989.7453665710946,2,3,2,7,2
8615,106,8,2806.969798545313,4,1,3,8,2
8616,224,17,2016.3313040709652,2,2,3,7,2
8617,273,21,1211.1676967233752,2,3,2,7,2
8618,232,26,1626.3599375616707,2,3,2,7,2
8619,256,28,1171.5215826306087,2,3,2,7,2
8620,24,39,1354.49377666836,5,4,2,11,1
8621,109,33,477.1026088062446,4,4,1,9,2
8622,191,40,2138.0489764122844,3,4,3,10,1
8623,347,19,1184.0666939500863,1,2,2,5,3
8624,25,29,2247.349096448436,5,3,3,11,1
8625,187,20,3963.069188539703,3,2,4,9,2
8626,288,20,2247.0786426834543,2,2,3,7,2
8627,116,10,4773.51323484148,4,1,5,10,1
8628,338,12,747.706103694824,1,2,1,4,3
8629,37,33,4252.822304280994,5,4,5,14,0
8630,282,25,1248.8079892242076,2,3,2,7,2
8631,137,25,4670.327919766321,4,3,5,12,1
8632,227,4,1143.4681529787863,2,1,2,5,3
8633,320,4,3737.3393119643797,1,1,4,6,3
8634,328,9,319.96832529125106,1,1,1,3,3
8635,182,15,3152.7690514292867,3,2,4,9,2
8636,362,26,1101.1843474005445,1,3,2,6,3
8637,86,15,3354.160982824698,4,2,4,10,1
8638,53,26,3182.7883947479863,5,3,4,12,1
8639,348,28,4619.242439504209,1,3,5,9,2
8640,355,7,3137.1153887960363,1,1,4,6,3
8641,235,32,2047.1615701330397,2,4,3,9,2
8642,267,12,975.9033461975235,2,2,1,5,3
8643,287,35,3290.680532635257,2,4,4,10,1
8644,100,32,590.6693535749341,4,4,1,9,2
8645,87,9,4144.298966339621,4,1,5,10,1
8646,15,14,1244.1993892249297,5,2,2,9,2
8647,101,13,2625.5529022611613,4,2,3,9,2
8648,165,44,2983.7770486036834,3,5,3,11,1
8649,29,33,1818.8250520834595,5,4,2,11,1
8650,114,32,3322.7301500855096,4,4,4,12,1
8651,107,19,1258.5826248717287,4,2,2,8,2
8652,364,30,182.7766231452113,1,3,1,5,3
8653,130,16,4796.746003313332,4,2,5,11,1
8654,84,12,1607.0286984023185,4,2,2,8,2
8655,271,10,3570.1765509557285,2,1,4,7,2
8656,244,2,2542.5926985327,2,1,3,6,3
8657,214,18,3348.303398793891,3,2,4,9,2
8658,306,13,563.573247353232,1,2,1,4,3
8659,166,29,2599.0508968293343,3,3,3,9,2
8660,279,24,1967.1755720259796,2,3,2,7,2
8661,59,38,2264.729338500201,5,4,3,12,1
8662,90,12,4831.3795813917395,4,2,5,11,1
8663,331,29,690.0816351360924,1,3,1,5,3
8664,194,22,3775.9538802928773,3,3,4,10,1
8665,123,36,1658.410542924674,4,4,2,10,1
8666,136,1,1458.8863582425738,4,1,2,7,2
8667,139,43,1361.179205537334,4,5,2,11,1
8668,229,40,1750.4199505822257,2,4,2,8,2
8669,274,34,1792.0141273720942,2,4,2,8,2
8670,50,34,1361.0275558580372,5,4,2,11,1
8671,118,48,3340.7908073896447,4,5,4,13,0
8672,202,33,248.1326986642444,3,4,1,8,2
8673,191,4,1668.1460909713621,3,1,2,6,3
8674,364,38,1408.225978111986,1,4,2,7,2
8675,323,30,3759.5759225438514,1,3,4,8,2
8676,181,46,741.0277346575693,3,5,1,9,2
8677,78,20,4704.028839065191,4,2,5,11,1
8678,75,26,860.8878741053232,4,3,1,8,2
8679,295,15,1856.4365466771205,1,2,2,5,3
8680,281,7,1006.5039652612218,2,1,1,4,3
8681,21,7,1440.6227379257318,5,1,2,8,2
8682,171,29,3807.513256333943,3,3,4,10,1
8683,15,23,2387.2595465044164,5,3,3,11,1
8684,211,34,821.2528293781475,3,4,1,8,2
8685,48,20,242.70804443642285,5,2,1,8,2
8686,86,15,1157.2819386496724,4,2,2,8,2
8687,149,33,4728.5578648448445,3,4,5,12,1
8688,188,17,4228.130573458287,3,2,5,10,1
8689,306,20,2206.466842460803,1,2,3,6,3
8690,151,13,2415.156157510455,3,2,3,8,2
8691,141,44,4497.837035501185,4,5,5,14,0
8692,69,24,2960.813458054919,5,3,3,11,1
8693,260,47,4405.027655092329,2,5,5,12,1
8694,334,37,2464.2771307181793,1,4,3,8,2
8695,9,7,1008.4871194029415,5,1,1,7,2
8696,121,8,3632.3756299117526,4,1,4,9,2
8697,101,23,2636.7026646992726,4,3,3,10,1
8698,149,14,3345.513504042659,3,2,4,9,2
8699,146,4,794.5822743304782,4,1,1,6,3
8700,353,21,3241.5329915755387,1,3,4,8,2
8701,243,46,1917.4631655515514,2,5,2,9,2
8702,241,10,1666.6687865278677,2,1,2,5,3
8703,337,22,3360.6629499522846,1,3,4,8,2
8704,43,30,2965.2731751721735,5,3,3,11,1
8705,95,30,3249.0460703941553,4,3,4,11,1
8706,226,16,4827.011990515141,2,2,5,9,2
8707,6,11,3508.970383151395,5,2,4,11,1
8708,214,22,3208.085821741724,3,3,4,10,1
8709,206,29,3071.6296787886076,3,3,4,10,1
8710,67,25,1999.5841042751588,5,3,2,10,1
8711,100,14,4197.566538799486,4,2,5,11,1
8712,12,14,1910.883626503496,5,2,2,9,2
8713,237,2,3504.2157352845534,2,1,4,7,2
8714,322,13,1472.786787126189,1,2,2,5,3
8715,258,3,747.3046444137726,2,1,1,4,3
8716,337,30,657.5189034170006,1,3,1,5,3
8717,135,18,3176.4486948870845,4,2,4,10,1
8718,222,36,1646.4951030931552,2,4,2,8,2
8719,156,21,1382.4959500760438,3,3,2,8,2
8720,142,19,2964.3760534887724,4,2,3,9,2
8721,158,16,138.0920747828545,3,2,1,6,3
8722,326,28,1238.6660034035258,1,3,2,6,3
8723,344,4,1709.3309537322668,1,1,2,4,3
8724,262,15,3544.7842171299185,2,2,4,8,2
8725,283,1,2729.556223347115,2,1,3,6,3
8726,338,48,4281.383199460983,1,5,5,11,1
8727,344,47,1679.1867513625493,1,5,2,8,2
8728,229,16,1489.240551454324,2,2,2,6,3
8729,280,20,175.6550687394025,2,2,1,5,3
8730,358,33,4759.069330185383,1,4,5,10,1
8731,290,17,2512.445810511391,2,2,3,7,2
8732,168,5,2517.5943343221365,3,1,3,7,2
8733,47,5,4617.946365274535,5,1,5,11,1
8734,203,39,1456.691997283613,3,4,2,9,2
8735,214,13,1667.2095889282718,3,2,2,7,2
8736,246,44,3285.174995031764,2,5,4,11,1
8737,24,36,3928.0280149479777,5,4,4,13,0
8738,321,30,3499.560519908131,1,3,4,8,2
8739,274,4,3945.704229786168,2,1,4,7,2
8740,44,23,2879.78911606008,5,3,3,11,1
8741,332,21,4315.489178730902,1,3,5,9,2
8742,313,21,2755.032583045128,1,3,3,7,2
8743,363,6,1154.4097299835332,1,1,2,4,3
8744,156,24,2713.088521428105,3,3,3,9,2
8745,199,47,3567.5939789332037,3,5,4,12,1
8746,162,31,3271.340943680408,3,4,4,11,1
8747,234,19,1222.6536472239718,2,2,2,6,3
8748,163,38,214.98035774055148,3,4,1,8,2
8749,116,12,1269.8789943490922,4,2,2,8,2
8750,93,14,4920.36993555606,4,2,5,11,1
8751,42,12,930.4865395483416,5,2,1,8,2
8752,284,15,2327.2150748695585,2,2,3,7,2
8753,210,19,3195.3455387942245,3,2,4,9,2
8754,206,28,4398.571193397215,3,3,5,11,1
8755,220,40,3803.690601275736,2,4,4,10,1
8756,280,41,4545.675996747409,2,5,5,12,1
8757,136,5,3025.8746309566404,4,1,3,8,2
8758,106,5,4327.940852557771,4,1,5,10,1
8759,118,6,1326.5765557246552,4,1,2,7,2
8760,237,23,2158.5185624276246,2,3,3,8,2
8761,309,3,4220.424647002879,1,1,5,7,2
8762,100,37,1634.562702211494,4,4,2,10,1
8763,261,33,4357.398499749591,2,4,5,11,1
8764,305,43,1821.9441887628072,1,5,2,8,2
8765,354,21,1823.3395715794784,1,3,2,6,3
8766,286,20,1552.0742448078108,2,2,2,6,3
8767,328,1,2739.245987351467,1,1,3,5,3
8768,103,39,654.0530071046126,4,4,1,9,2
8769,63,47,192.64723272161606,5,5,1,11,1
8770,175,17,4488.090770055243,3,2,5,10,1
8771,282,29,4645.401890323222,2,3,5,10,1
8772,293,8,390.0916028407052,1,1,1,3,3
8773,226,26,2752.9907992578483,2,3,3,8,2
8774,7,28,2703.0139771783543,5,3,3,11,1
8775,127,34,1868.4290952839108,4,4,2,10,1
8776,92,26,2848.8350543180045,4,3,3,10,1
8777,190,13,2296.015535183044,3,2,3,8,2
8778,359,44,2453.278720880727,1,5,3,9,2
8779,53,37,3779.1307472052963,5,4,4,13,0
8780,242,13,2634.5417339972446,2,2,3,7,2
8781,132,38,1625.0538830985756,4,4,2,10,1
8782,364,25,2911.4659993238893,1,3,3,7,2
8783,112,47,3207.3624454098667,4,5,4,13,0
8784,7,23,3314.9336065568305,5,3,4,12,1
8785,230,22,3095.350188375093,2,3,4,9,2
8786,156,21,3326.3677960665714,3,3,4,10,1
8787,197,30,1557.3629904996192,3,3,2,8,2
8788,323,11,2236.2082262656936,1,2,3,6,3
8789,364,4,3346.843784579195,1,1,4,6,3
8790,223,33,3774.2990226071815,2,4,4,10,1
8791,250,47,2176.389182004561,2,5,3,10,1
8792,83,12,1833.0108891495559,4,2,2,8,2
8793,240,9,3582.2544493125633,2,1,4,7,2
8794,360,32,1118.644167378345,1,4,2,7,2
8795,323,11,57.366055724632815,1,2,1,4,3
8796,263,37,2361.1183522277097,2,4,3,9,2
8797,189,24,875.1320425834409,3,3,1,7,2
8798,290,7,1897.6309675913471,2,1,2,5,3
8799,362,8,1463.2584098139473,1,1,2,4,3
8800,58,33,3888.5368236854706,5,4,4,13,0
8801,9,25,1663.7284120051531,5,3,2,10,1
8802,304,1,3206.972199032721,1,1,4,6,3
8803,115,3,3372.823857030613,4,1,4,9,2
8804,210,40,2287.706884906253,3,4,3,10,1
8805,41,28,414.57889828926903,5,3,1,9,2
8806,304,43,3504.821779516275,1,5,4,10,1
8807,173,33,385.0878942300846,3,4,1,8,2
8808,234,46,505.0726689065029,2,5,1,8,2
8809,281,1,988.0268701866952,2,1,1,4,3
8810,78,38,1409.0752309629079,4,4,2,10,1
8811,108,27,4233.793984602032,4,3,5,12,1
8812,281,38,3377.859667751441,2,4,4,10,1
8813,39,35,1942.1918141996334,5,4,2,11,1
8814,119,10,4893.350981292159,4,1,5,10,1
8815,335,12,1225.5766859928976,1,2,2,5,3
8816,336,10,3052.9737930474294,1,1,4,6,3
8817,27,34,4237.598403675882,5,4,5,14,0
8818,104,24,4012.092664004357,4,3,4,11,1
8819,74,28,460.6356653424774,4,3,1,8,2
8820,191,22,3489.398376135969,3,3,4,10,1
8821,324,45,1296.7401402079327,1,5,2,8,2
8822,147,16,1785.110055546679,3,2,2,7,2
8823,255,13,2450.0699917327156,2,2,3,7,2
8824,284,36,3955.8433286663135,2,4,4,10,1
8825,213,36,839.3451989185457,3,4,1,8,2
8826,123,43,551.6906228476875,4,5,1,10,1
8827,206,23,775.6718127677868,3,3,1,7,2
8828,240,14,1098.9354426039959,2,2,2,6,3
8829,339,32,306.9142505170353,1,4,1,6,3
8830,286,3,4632.518783154686,2,1,5,8,2
8831,22,27,1602.2262013728543,5,3,2,10,1
8832,259,19,893.1083930334387,2,2,1,5,3
8833,357,22,3192.7926763735304,1,3,4,8,2
8834,105,1,3937.1106326454787,4,1,4,9,2
8835,258,5,3768.63848635107,2,1,4,7,2
8836,204,49,3596.3488920075906,3,5,4,12,1
8837,310,33,262.14457743545586,1,4,1,6,3
8838,262,19,3912.976000910027,2,2,4,8,2
8839,107,36,2514.374419846772,4,4,3,11,1
8840,251,6,3248.939239957269,2,1,4,7,2
8841,221,15,4782.55887645074,2,2,5,9,2
8842,222,36,4055.255966985539,2,4,5,11,1
8843,258,33,4128.606326037764,2,4,5,11,1
8844,201,24,915.5214222020765,3,3,1,7,2
8845,258,27,2387.321460352092,2,3,3,8,2
8846,349,49,4747.134170201675,1,5,5,11,1
8847,225,11,2917.59940783282,2,2,3,7,2
8848,202,49,521.905985123549,3,5,1,9,2
8849,226,23,3661.780926177354,2,3,4,9,2
8850,236,33,224.20496705419902,2,4,1,7,2
8851,183,41,3714.063362348656,3,5,4,12,1
8852,200,46,4400.065409342011,3,5,5,13,0
8853,357,47,2131.998201660541,1,5,3,9,2
8854,246,29,2073.9281862955854,2,3,3,8,2
8855,353,31,1528.0147725010856,1,4,2,7,2
8856,111,1,4385.922042667627,4,1,5,10,1
8857,6,34,2743.4451742014508,5,4,3,12,1
8858,236,18,2900.507103766748,2,2,3,7,2
8859,127,18,3311.9198803412733,4,2,4,10,1
8860,104,6,1508.1524283387564,4,1,2,7,2
8861,237,40,2169.603693638555,2,4,3,9,2
8862,155,1,3710.612753409431,3,1,4,8,2
8863,257,47,4927.579973009537,2,5,5,12,1
8864,235,42,181.18464492200587,2,5,1,8,2
8865,289,30,222.81600475337154,2,3,1,6,3
8866,40,4,2146.1315850948117,5,1,3,9,2
8867,288,32,3301.5129556999705,2,4,4,10,1
8868,197,10,1937.959477928231,3,1,2,6,3
8869,273,43,4998.196883286245,2,5,5,12,1
8870,264,5,984.8426978498179,2,1,1,4,3
8871,57,9,49.54803545706322,5,1,1,7,2
8872,298,5,958.7455179407178,1,1,1,3,3
8873,98,11,4435.343451755492,4,2,5,11,1
8874,137,35,734.2934744136384,4,4,1,9,2
8875,87,27,2400.0841537301376,4,3,3,10,1
8876,242,4,2102.188141800026,2,1,3,6,3
8877,199,10,3331.969353242733,3,1,4,8,2
8878,310,39,282.4319762330702,1,4,1,6,3
8879,84,33,3297.1633536204677,4,4,4,12,1
8880,242,38,1780.2107034718535,2,4,2,8,2
8881,281,8,4630.937399821669,2,1,5,8,2
8882,323,49,4245.947774633671,1,5,5,11,1
8883,252,24,2003.5361799031546,2,3,2,7,2
8884,190,39,4964.530299154085,3,4,5,12,1
8885,152,33,269.1993257546734,3,4,1,8,2
8886,302,41,3945.274778120312,1,5,4,10,1
8887,278,43,2174.8442548965395,2,5,3,10,1
8888,139,19,2172.192671492051,4,2,3,9,2
8889,176,2,858.96765274526,3,1,1,5,3
8890,8,11,2579.2508006615817,5,2,3,10,1
8891,295,35,432.7452994316254,1,4,1,6,3
8892,235,17,3086.7201232118828,2,2,4,8,2
8893,163,42,1215.5362998608973,3,5,2,10,1
8894,49,3,3627.0416483891568,5,1,4,10,1
8895,302,22,3040.7339761002977,1,3,4,8,2
8896,38,35,3734.560993669715,5,4,4,13,0
8897,136,21,3751.212930468714,4,3,4,11,1
8898,310,25,991.5781356500015,1,3,1,5,3
8899,219,39,13.366900138114449,2,4,1,7,2
8900,348,2,1835.1486843697608,1,1,2,4,3
8901,296,1,4596.15538682458,1,1,5,7,2
8902,34,7,2893.7179293328127,5,1,3,9,2
8903,352,20,3640.2350080688343,1,2,4,7,2
8904,79,43,4399.055984242529,4,5,5,14,0
8905,236,6,4531.230656146238,2,1,5,8,2
8906,273,36,2649.835534974042,2,4,3,9,2
8907,161,21,2709.301003711155,3,3,3,9,2
8908,175,46,4256.184817753251,3,5,5,13,0
8909,308,35,4039.3523220971683,1,4,5,10,1
8910,221,36,3497.3044135281725,2,4,4,10,1
8911,9,8,3026.2768276403694,5,1,3,9,2
8912,289,4,3089.903361867015,2,1,4,7,2
8913,113,43,1820.927609670692,4,5,2,11,1
8914,205,16,4206.179559534438,3,2,5,10,1
8915,186,3,3092.720728385432,3,1,4,8,2
8916,341,7,1125.4050305852397,1,1,2,4,3
8917,197,2,1206.8179597625963,3,1,2,6,3
8918,266,1,4309.399038728416,2,1,5,8,2
8919,262,1,3132.280652726578,2,1,4,7,2
8920,248,38,1999.5336008553797,2,4,2,8,2
8921,115,7,943.632788584085,4,1,1,6,3
8922,121,24,3054.9777064935565,4,3,4,11,1
8923,141,5,929.7087962973302,4,1,1,6,3
8924,65,21,2356.133485779322,5,3,3,11,1
8925,276,28,3390.7775658637693,2,3,4,9,2
8926,313,18,2831.4230172623925,1,2,3,6,3
8927,239,24,4611.278501630079,2,3,5,10,1
8928,302,32,208.2087972403272,1,4,1,6,3
8929,10,45,1406.1764304985002,5,5,2,12,1
8930,233,33,294.8596451775256,2,4,1,7,2
8931,195,10,981.0751078072826,3,1,1,5,3
8932,12,9,628.676845869198,5,1,1,7,2
8933,177,49,3665.981518830955,3,5,4,12,1
8934,177,33,1853.185947059046,3,4,2,9,2
8935,217,33,4625.970913303073,3,4,5,12,1
8936,11,7,126.65483124343194,5,1,1,7,2
8937,118,4,3268.0916828714485,4,1,4,9,2
8938,164,28,4853.018553324787,3,3,5,11,1
8939,39,23,887.435211851993,5,3,1,9,2
8940,53,32,2217.7368291250536,5,4,3,12,1
8941,218,44,3512.430556939668,2,5,4,11,1
8942,206,16,3169.3586166226073,3,2,4,9,2
8943,312,46,2834.4753815226973,1,5,3,9,2
8944,360,10,1640.5130740014818,1,1,2,4,3
8945,56,14,3643.7177681291773,5,2,4,11,1
8946,118,39,3269.743832570998,4,4,4,12,1
8947,253,36,822.3734243643198,2,4,1,7,2
8948,286,34,4820.812749215424,2,4,5,11,1
8949,268,24,2782.807815611196,2,3,3,8,2
8950,291,18,2632.053389169149,2,2,3,7,2
8951,333,16,4242.701021161473,1,2,5,8,2
8952,180,41,3205.6634180385936,3,5,4,12,1
8953,358,37,381.6516401658126,1,4,1,6,3
8954,235,41,2537.880975213397,2,5,3,10,1
8955,343,25,3905.1764995411268,1,3,4,8,2
8956,196,8,3502.900799682687,3,1,4,8,2
8957,308,24,4854.1359334723065,1,3,5,9,2
8958,80,20,134.3322356327958,4,2,1,7,2
8959,135,48,1313.482593635605,4,5,2,11,1
8960,22,30,2750.290716849303,5,3,3,11,1
8961,331,20,3101.2540971135386,1,2,4,7,2
8962,225,18,1379.0363696796433,2,2,2,6,3
8963,58,4,4135.740315215562,5,1,5,11,1
8964,93,48,830.0954866509043,4,5,1,10,1
8965,192,36,14.237057012373498,3,4,1,8,2
8966,103,6,4762.433077896887,4,1,5,10,1
8967,7,3,1963.8684042061975,5,1,2,8,2
8968,128,18,4787.874106770907,4,2,5,11,1
8969,55,47,1396.8786857226678,5,5,2,12,1
8970,231,40,326.60868930481723,2,4,1,7,2
8971,362,18,3864.8728267195856,1,2,4,7,2
8972,62,23,4180.739463810234,5,3,5,13,0
8973,240,35,2465.513625249703,2,4,3,9,2
8974,90,6,378.51319748754446,4,1,1,6,3
8975,232,26,3274.1290341169556,2,3,4,9,2
8976,233,21,918.8984326310349,2,3,1,6,3
8977,354,24,4248.413925299858,1,3,5,9,2
8978,333,15,1377.3753665155339,1,2,2,5,3
8979,292,27,4240.054887666499,1,3,5,9,2
8980,345,32,2140.3534640486614,1,4,3,8,2
8981,152,12,2986.4743178482718,3,2,3,8,2
8982,145,5,3949.916958936622,4,1,4,9,2
8983,130,7,211.79182248482735,4,1,1,6,3
8984,141,22,4107.618370887027,4,3,5,12,1
8985,93,27,701.853728409833,4,3,1,8,2
8986,114,15,1798.5075924629025,4,2,2,8,2
8987,284,39,2369.177340254205,2,4,3,9,2
8988,143,45,4478.178652506456,4,5,5,14,0
8989,223,35,121.97873319899955,2,4,1,7,2
8990,232,26,2800.421015400959,2,3,3,8,2
8991,33,23,3216.187275311349,5,3,4,12,1
8992,276,13,1589.7457224043767,2,2,2,6,3
8993,170,26,1459.5289888342043,3,3,2,8,2
8994,140,3,2457.441100967233,4,1,3,8,2
8995,357,29,943.6310851447162,1,3,1,5,3
8996,201,2,2345.9134587287463,3,1,3,7,2
8997,23,28,3827.4763642158355,5,3,4,12,1
8998,224,23,4228.523565760969,2,3,5,10,1
8999,270,36,1931.9553106455146,2,4,2,8,2
9000,347,49,3090.3355485869906,1,5,4,10,1
9001,153,6,10.102384624865913,3,1,1,5,3
9002,333,11,2756.2588935205467,1,2,3,6,3
9003,85,38,4876.429163908524,4,4,5,13,0
9004,109,34,1568.2024855344448,4,4,2,10,1
9005,31,17,2977.932859804138,5,2,3,10,1
9006,229,3,3813.795451651609,2,1,4,7,2
9007,240,44,3048.575774738317,2,5,4,11,1
9008,363,46,2098.3148526295286,1,5,3,9,2
9009,310,34,771.3521108145618,1,4,1,6,3
9010,141,22,2323.8699733165718,4,3,3,10,1
9011,156,29,1480.973203801172,3,3,2,8,2
9012,299,29,3482.6422409188744,1,3,4,8,2
9013,345,5,2215.1447108952384,1,1,3,5,3
9014,99,10,4250.900025390534,4,1,5,10,1
9015,47,10,974.6789600969503,5,1,1,7,2
9016,327,9,2094.423409047332,1,1,3,5,3
9017,67,21,2791.949832210093,5,3,3,11,1
9018,62,13,638.813233381193,5,2,1,8,2
9019,109,10,2943.6712883940995,4,1,3,8,2
9020,167,38,1461.6978125846044,3,4,2,9,2
9021,37,11,1155.390528941811,5,2,2,9,2
9022,119,4,718.1345912494304,4,1,1,6,3
9023,86,46,1755.9108089112208,4,5,2,11,1
9024,52,31,4645.622251819092,5,4,5,14,0
9025,91,49,164.71923806198183,4,5,1,10,1
9026,289,34,4262.259479456617,2,4,5,11,1
9027,337,42,1992.8308799478527,1,5,2,8,2
9028,298,35,2812.3921772446593,1,4,3,8,2
9029,204,39,2568.933361657604,3,4,3,10,1
9030,238,39,4629.443905420096,2,4,5,11,1
9031,155,33,3852.9450533365107,3,4,4,11,1
9032,240,8,4924.269441286467,2,1,5,8,2
9033,136,32,3974.20545859227,4,4,4,12,1
9034,362,33,1486.4835860913695,1,4,2,7,2
9035,64,8,4814.789560002977,5,1,5,11,1
9036,123,46,4917.993296131538,4,5,5,14,0
9037,254,14,624.2375810473303,2,2,1,5,3
9038,114,34,4506.210477077056,4,4,5,13,0
9039,20,8,3324.368892636879,5,1,4,10,1
9040,16,42,4610.7489124652375,5,5,5,15,0
9041,145,7,4579.537710892744,4,1,5,10,1
9042,208,13,4457.951425624212,3,2,5,10,1
9043,19,21,4427.5252124750705,5,3,5,13,0
9044,166,47,597.0547325761607,3,5,1,9,2
9045,38,32,726.1433843085273,5,4,1,10,1
9046,181,11,597.7193026910637,3,2,1,6,3
9047,349,14,464.23515311342345,1,2,1,4,3
9048,105,11,1772.893572519202,4,2,2,8,2
9049,100,2,3422.9524874799645,4,1,4,9,2
9050,90,34,1779.9161392321987,4,4,2,10,1
9051,300,44,3604.298663042723,1,5,4,10,1
9052,332,47,4103.212793850811,1,5,5,11,1
9053,79,17,3334.411553330621,4,2,4,10,1
9054,73,14,2330.872584152014,5,2,3,10,1
9055,176,25,1484.6320235588748,3,3,2,8,2
9056,96,48,630.772778651602,4,5,1,10,1
9057,345,27,2473.322621277805,1,3,3,7,2
9058,103,8,3600.7987773157884,4,1,4,9,2
9059,224,17,2745.733625405201,2,2,3,7,2
9060,6,5,3610.1947772594094,5,1,4,10,1
9061,122,12,1682.7461649940685,4,2,2,8,2
9062,236,38,343.31235464618663,2,4,1,7,2
9063,116,18,3857.7786509025573,4,2,4,10,1
9064,163,26,1106.4233180294843,3,3,2,8,2
9065,226,31,3085.2624505777594,2,4,4,10,1
9066,230,37,4023.420795328119,2,4,5,11,1
9067,182,6,704.1589092049368,3,1,1,5,3
9068,249,41,2996.488602966246,2,5,3,10,1
9069,318,15,3449.978065582068,1,2,4,7,2
9070,210,42,3735.189025426433,3,5,4,12,1
9071,144,49,746.8563895960232,4,5,1,10,1
9072,345,26,4127.329648277064,1,3,5,9,2
9073,96,12,479.8013450908451,4,2,1,7,2
9074,346,41,2602.7215061024685,1,5,3,9,2
9075,244,47,2222.629354027421,2,5,3,10,1
9076,86,14,1116.612710435411,4,2,2,8,2
9077,184,1,1516.6343998217235,3,1,2,6,3
9078,121,17,830.5345586116202,4,2,1,7,2
9079,332,33,2134.3737121580543,1,4,3,8,2
9080,92,29,187.1995285770953,4,3,1,8,2
9081,70,45,4445.687223727816,5,5,5,15,0
9082,133,31,825.8018018326105,4,4,1,9,2
9083,279,8,4431.228604715184,2,1,5,8,2
9084,137,30,4319.251226668676,4,3,5,12,1
9085,314,13,2263.869263716857,1,2,3,6,3
9086,187,16,2493.6513039533106,3,2,3,8,2
9087,221,2,1516.548567267062,2,1,2,5,3
9088,46,45,4984.404253877896,5,5,5,15,0
9089,278,18,3357.153231045215,2,2,4,8,2
9090,192,35,4759.523346818406,3,4,5,12,1
9091,8,45,2079.836253497009,5,5,3,13,0
9092,276,19,4416.252731369604,2,2,5,9,2
9093,179,13,2246.6908197531643,3,2,3,8,2
9094,334,4,4335.47607178555,1,1,5,7,2
9095,39,19,663.3235318793496,5,2,1,8,2
9096,293,25,3187.9035895748607,1,3,4,8,2
9097,178,38,3396.730539047342,3,4,4,11,1
9098,162,31,3284.2917794592727,3,4,4,11,1
9099,331,36,2240.667814016325,1,4,3,8,2
9100,104,4,3422.7413890536714,4,1,4,9,2
9101,161,39,1204.9208730747994,3,4,2,9,2
9102,287,7,2983.28448654046,2,1,3,6,3
9103,123,16,2775.632273002153,4,2,3,9,2
9104,54,48,1598.5142154308303,5,5,2,12,1
9105,34,5,3896.530406816335,5,1,4,10,1
9106,242,47,413.55160663881804,2,5,1,8,2
9107,113,23,865.4839098474293,4,3,1,8,2
9108,318,36,2361.038697700995,1,4,3,8,2
9109,23,32,4459.766122646228,5,4,5,14,0
9110,46,24,2880.046177094457,5,3,3,11,1
9111,312,25,4211.913586186573,1,3,5,9,2
9112,135,45,2592.6728985464906,4,5,3,12,1
9113,118,28,3929.42528336862,4,3,4,11,1
9114,189,19,1635.7289997806697,3,2,2,7,2
9115,131,7,4077.5601627663136,4,1,5,10,1
9116,212,44,2014.4134921231862,3,5,3,11,1
9117,113,41,2798.567495445162,4,5,3,12,1
9118,44,17,887.6486427355032,5,2,1,8,2
9119,128,2,4602.960790286727,4,1,5,10,1
9120,364,16,3510.2810059920025,1,2,4,7,2
9121,158,39,4295.6855475554,3,4,5,12,1
9122,273,18,1047.235906705608,2,2,2,6,3
9123,315,39,347.74493279348985,1,4,1,6,3
9124,355,1,1692.6742239219636,1,1,2,4,3
9125,340,3,2588.26010086511,1,1,3,5,3
9126,45,21,4013.825715965586,5,3,4,12,1
9127,108,30,1994.6548133753809,4,3,2,9,2
9128,219,11,1357.0920412562805,2,2,2,6,3
9129,318,22,1869.0001109527486,1,3,2,6,3
9130,315,47,3521.000978201167,1,5,4,10,1
9131,177,25,1687.7283037855748,3,3,2,8,2
9132,228,3,4896.036475512156,2,1,5,8,2
9133,191,30,883.1456527164908,3,3,1,7,2
9134,160,24,3767.9496619236734,3,3,4,10,1
9135,267,45,2949.926425788292,2,5,3,10,1
9136,358,36,1173.1470447811432,1,4,2,7,2
9137,326,23,3770.532049331986,1,3,4,8,2
9138,190,8,2243.2256506836775,3,1,3,7,2
9139,175,4,3415.167394959671,3,1,4,8,2
9140,290,39,3314.663653371564,2,4,4,10,1
9141,357,43,562.1107319078505,1,5,1,7,2
9142,145,31,4201.515294060119,4,4,5,13,0
9143,232,29,3410.559782827812,2,3,4,9,2
9144,360,36,3905.1276960569567,1,4,4,9,2
9145,204,13,2244.3515164707032,3,2,3,8,2
9146,213,41,983.3579912969549,3,5,1,9,2
9147,40,9,1637.805483499184,5,1,2,8,2
9148,275,21,4508.331449687338,2,3,5,10,1
9149,323,3,4690.712823238628,1,1,5,7,2
9150,82,25,2414.513328651166,4,3,3,10,1
9151,181,25,1500.9899199954768,3,3,2,8,2
9152,320,12,3654.2525093014037,1,2,4,7,2
9153,83,29,3832.3051212287123,4,3,4,11,1
9154,303,11,4079.176824060503,1,2,5,8,2
9155,262,11,165.10821550525503,2,2,1,5,3
9156,272,49,58.572023259199405,2,5,1,8,2
9157,200,26,1792.2065851264442,3,3,2,8,2
9158,240,14,770.9581227047839,2,2,1,5,3
9159,180,16,4026.859473985431,3,2,5,10,1
9160,171,10,2668.890829357425,3,1,3,7,2
9161,295,31,4128.487150545371,1,4,5,10,1
9162,177,31,892.7962529532343,3,4,1,8,2
9163,237,36,3139.8413172205205,2,4,4,10,1
9164,138,10,2905.0587332680134,4,1,3,8,2
9165,327,26,1708.4877211879495,1,3,2,6,3
9166,311,20,2590.2356897832296,1,2,3,6,3
9167,129,44,2949.2474102523456,4,5,3,12,1
9168,49,9,4448.544144633749,5,1,5,11,1
9169,164,15,287.63553993335813,3,2,1,6,3
9170,277,9,4118.635595455555,2,1,5,8,2
9171,293,7,4900.980382511928,1,1,5,7,2
9172,116,26,3661.557539962076,4,3,4,11,1
9173,24,24,3689.3614414813437,5,3,4,12,1
9174,311,12,1097.6917442260797,1,2,2,5,3
9175,25,20,2620.1356719361947,5,2,3,10,1
9176,127,14,3532.642197714494,4,2,4,10,1
9177,234,22,3015.3822117210716,2,3,3,8,2
9178,209,16,1931.8067195127364,3,2,2,7,2
9179,93,29,4701.190866178217,4,3,5,12,1
9180,94,32,2574.7938395254887,4,4,3,11,1
9181,327,19,4849.680568523288,1,2,5,8,2
9182,225,35,2823.7396506970913,2,4,3,9,2
9183,280,43,3968.983398947809,2,5,4,11,1
9184,11,32,3712.6952847375633,5,4,4,13,0
9185,329,20,3307.5106382127037,1,2,4,7,2
9186,12,40,82.1596203115164,5,4,1,10,1
9187,35,20,396.37146099652176,5,2,1,8,2
9188,228,8,2911.606598141162,2,1,3,6,3
9189,220,35,4559.789294459064,2,4,5,11,1
9190,141,42,3009.6969176455955,4,5,3,12,1
9191,23,13,1187.620019230783,5,2,2,9,2
9192,83,41,1607.8898240615797,4,5,2,11,1
9193,229,6,3119.5677716605564,2,1,4,7,2
9194,344,47,2989.3017834189363,1,5,3,9,2
9195,80,16,4778.957521973372,4,2,5,11,1
9196,353,5,2650.1319743976696,1,1,3,5,3
9197,290,45,1781.524261046465,2,5,2,9,2
9198,331,34,2629.713856139677,1,4,3,8,2
9199,159,6,3933.3075765213007,3,1,4,8,2
9200,128,33,2706.4153908615444,4,4,3,11,1
9201,190,15,1637.0022259356922,3,2,2,7,2
9202,31,15,1699.7190450143414,5,2,2,9,2
9203,359,14,3786.4909780193293,1,2,4,7,2
9204,15,39,341.57690153779646,5,4,1,10,1
9205,313,5,1381.0288281108167,1,1,2,4,3
9206,75,26,773.6575761386225,4,3,1,8,2
9207,34,48,4723.931409654185,5,5,5,15,0
9208,359,17,459.57037320921063,1,2,1,4,3
9209,196,43,3793.3362118853206,3,5,4,12,1
9210,331,47,3155.82359165116,1,5,4,10,1
9211,29,16,3167.6939593481466,5,2,4,11,1
9212,194,35,3819.5308054679467,3,4,4,11,1
9213,16,38,2008.4349806482296,5,4,2,11,1
9214,77,23,2009.7093913363974,4,3,3,10,1
9215,293,13,1450.641853364904,1,2,2,5,3
9216,81,33,2992.7726840594473,4,4,3,11,1
9217,124,29,4649.728208030188,4,3,5,12,1
9218,19,46,4620.676164960747,5,5,5,15,0
9219,102,34,3517.7737541851125,4,4,4,12,1
9220,77,34,4531.86699745492,4,4,5,13,0
9221,229,27,4817.958953495285,2,3,5,10,1
9222,297,15,3977.5736655839287,1,2,4,7,2
9223,203,9,2045.0883114272976,3,1,3,7,2
9224,61,26,2421.2925819952084,5,3,3,11,1
9225,26,3,4656.972031277037,5,1,5,11,1
9226,71,36,3353.340295620804,5,4,4,13,0
9227,103,47,4105.262866319015,4,5,5,14,0
9228,326,5,589.4090383696348,1,1,1,3,3
9229,363,20,977.5680613023145,1,2,1,4,3
9230,157,20,1727.1012519416145,3,2,2,7,2
9231,363,5,949.320871242167,1,1,1,3,3
9232,359,10,4533.260672611185,1,1,5,7,2
9233,194,16,1092.2838295173838,3,2,2,7,2
9234,275,25,2790.3467345091753,2,3,3,8,2
9235,324,44,436.41481204589036,1,5,1,7,2
9236,186,25,783.2596141541047,3,3,1,7,2
9237,326,30,1244.6015235063126,1,3,2,6,3
9238,113,14,4914.638073407086,4,2,5,11,1
9239,313,22,3987.348147449521,1,3,4,8,2
9240,165,43,3371.0397432601494,3,5,4,12,1
9241,61,28,4582.147299410512,5,3,5,13,0
9242,92,30,4781.4812102443975,4,3,5,12,1
9243,286,19,2273.3288422509586,2,2,3,7,2
9244,153,38,1645.1703527187137,3,4,2,9,2
9245,225,42,1583.4234810028283,2,5,2,9,2
9246,127,20,188.28821938642815,4,2,1,7,2
9247,193,35,1405.394087694426,3,4,2,9,2
9248,115,22,1781.6793762967823,4,3,2,9,2
9249,262,15,194.12520884918078,2,2,1,5,3
9250,18,11,4414.19802993829,5,2,5,12,1
9251,10,34,4240.8051116407205,5,4,5,14,0
9252,92,24,1264.98959047267,4,3,2,9,2
9253,139,6,4014.7689125448314,4,1,4,9,2
9254,333,17,3983.0972766177542,1,2,4,7,2
9255,357,28,1681.713671077902,1,3,2,6,3
9256,340,31,3488.3695127691603,1,4,4,9,2
9257,52,36,1456.3906117703707,5,4,2,11,1
9258,195,9,360.67841707962265,3,1,1,5,3
9259,206,10,2528.9411913056033,3,1,3,7,2
9260,287,21,2197.2519339865057,2,3,3,8,2
9261,93,34,699.3830434517009,4,4,1,9,2
9262,309,31,2457.861151580521,1,4,3,8,2
9263,145,29,4747.384971327012,4,3,5,12,1
9264,86,43,3659.6518044737595,4,5,4,13,0
9265,153,43,3696.972826629513,3,5,4,12,1
9266,2,11,3790.1784674606283,5,2,4,11,1
9267,342,33,3725.7226982700427,1,4,4,9,2
9268,260,46,109.30816264902762,2,5,1,8,2
9269,164,1,4624.207769112719,3,1,5,9,2
9270,6,21,4152.3874445494785,5,3,5,13,0
9271,149,23,1380.1512430906835,3,3,2,8,2
9272,205,9,2768.190089134785,3,1,3,7,2
9273,118,1,3078.8795904663043,4,1,4,9,2
9274,89,21,668.4056952900629,4,3,1,8,2
9275,154,22,1277.277250517066,3,3,2,8,2
9276,167,4,126.01967206791872,3,1,1,5,3
9277,161,1,4321.119083070784,3,1,5,9,2
9278,270,10,134.27629803354017,2,1,1,4,3
9279,56,15,1600.2922309257262,5,2,2,9,2
9280,228,36,400.4499998016533,2,4,1,7,2
9281,337,29,3909.2155715935505,1,3,4,8,2
9282,149,46,4625.664037625227,3,5,5,13,0
9283,46,5,2818.449942890784,5,1,3,9,2
9284,144,29,706.438418368525,4,3,1,8,2
9285,238,47,2795.2226828476464,2,5,3,10,1
9286,272,47,3854.0027848688665,2,5,4,11,1
9287,120,27,3594.89686407924,4,3,4,11,1
9288,340,25,3711.1778392741103,1,3,4,8,2
9289,220,16,1403.0774743418535,2,2,2,6,3
9290,8,16,377.9502376953689,5,2,1,8,2
9291,344,36,753.3285563567664,1,4,1,6,3
9292,275,25,4777.977360543914,2,3,5,10,1
9293,353,41,3071.434795608946,1,5,4,10,1
9294,66,1,3642.2190332609885,5,1,4,10,1
9295,79,5,4496.332312985223,4,1,5,10,1
9296,86,41,4265.2452870909465,4,5,5,14,0
9297,124,20,1099.8252300984038,4,2,2,8,2
9298,202,5,299.71962259768094,3,1,1,5,3
9299,150,36,4626.389722308659,3,4,5,12,1
9300,46,29,4908.524780262407,5,3,5,13,0
9301,113,48,2841.0475256347363,4,5,3,12,1
9302,91,34,4443.125555040519,4,4,5,13,0
9303,141,48,1166.7620880766192,4,5,2,11,1
9304,289,18,564.0831359033581,2,2,1,5,3
9305,218,2,2504.086517667986,2,1,3,6,3
9306,77,16,4057.8052632240924,4,2,5,11,1
9307,334,29,3276.7215799692585,1,3,4,8,2
9308,152,33,3190.227639037389,3,4,4,11,1
9309,323,16,97.11995204357913,1,2,1,4,3
9310,239,35,1594.2895329018054,2,4,2,8,2
9311,115,47,4698.083974747182,4,5,5,14,0
9312,319,43,680.024962189448,1,5,1,7,2
9313,94,42,3634.5660664838997,4,5,4,13,0
9314,48,17,3798.9626575021425,5,2,4,11,1
9315,191,4,3666.8378835295207,3,1,4,8,2
9316,12,49,4946.5316215598805,5,5,5,15,0
9317,156,4,2051.9489746461045,3,1,3,7,2
9318,172,25,3414.1450271230065,3,3,4,10,1
9319,296,33,976.3390157851738,1,4,1,6,3
9320,177,14,2004.5524801967288,3,2,2,7,2
9321,341,24,2462.887406141301,1,3,3,7,2
9322,57,11,1081.9894300891276,5,2,2,9,2
9323,343,25,4534.9856043707105,1,3,5,9,2
9324,340,28,3583.8271740321384,1,3,4,8,2
9325,203,7,1425.9512627815488,3,1,2,6,3
9326,185,49,683.4326320949954,3,5,1,9,2
9327,121,36,1446.4579688283136,4,4,2,10,1
9328,226,10,3118.697057392991,2,1,4,7,2
9329,202,49,4133.779105168326,3,5,5,13,0
9330,330,36,2520.8096027052507,1,4,3,8,2
9331,363,31,521.448420787525,1,4,1,6,3
9332,356,19,1254.0811833913403,1,2,2,5,3
9333,216,18,1732.2681577538663,3,2,2,7,2
9334,43,49,3184.319906018023,5,5,4,14,0
9335,23,6,1240.7504430547594,5,1,2,8,2
9336,155,28,1177.3026793429203,3,3,2,8,2
9337,186,7,1438.1473244197591,3,1,2,6,3
9338,249,38,2966.719931823209,2,4,3,9,2
9339,237,12,2468.225116871414,2,2,3,7,2
9340,293,41,4209.763406979179,1,5,5,11,1
9341,134,34,3492.682248922431,4,4,4,12,1
9342,321,25,3337.4411410620896,1,3,4,8,2
9343,22,17,781.703809403022,5,2,1,8,2
9344,361,33,285.5867150748069,1,4,1,6,3
9345,88,23,2554.894334150765,4,3,3,10,1
9346,153,9,367.4919102039654,3,1,1,5,3
9347,125,6,1826.4494004724186,4,1,2,7,2
9348,79,2,140.3006183243271,4,1,1,6,3
9349,346,38,892.2767933829574,1,4,1,6,3
9350,51,9,560.7356647592443,5,1,1,7,2
9351,216,3,4006.9151698396145,3,1,4,8,2
9352,176,16,1737.1695013051067,3,2,2,7,2
9353,358,25,403.4441261772632,1,3,1,5,3
9354,253,24,1334.7462206529995,2,3,2,7,2
9355,246,47,3417.2123494888474,2,5,4,11,1
9356,227,29,3730.720008140054,2,3,4,9,2
9357,106,44,608.1269979491116,4,5,1,10,1
9358,193,40,3895.046535270328,3,4,4,11,1
9359,316,26,1859.0901995032195,1,3,2,6,3
9360,302,38,3400.119517985667,1,4,4,9,2
9361,36,35,3360.823868591751,5,4,4,13,0
9362,204,23,3970.0276781774205,3,3,4,10,1
9363,267,4,3488.9420737421406,2,1,4,7,2
9364,268,42,203.95309979577607,2,5,1,8,2
9365,170,14,2602.210743338846,3,2,3,8,2
9366,39,47,839.2440556201494,5,5,1,11,1
9367,139,39,4850.123042088524,4,4,5,13,0
9368,292,7,1286.614347170378,1,1,2,4,3
9369,52,8,2106.3356828334236,5,1,3,9,2
9370,287,42,991.5437373494527,2,5,1,8,2
9371,289,19,681.5997777516365,2,2,1,5,3
9372,141,2,3008.6387070125143,4,1,3,8,2
9373,146,47,2470.966447220188,4,5,3,12,1
9374,314,1,1879.5520731741763,1,1,2,4,3
9375,184,42,436.2409205361113,3,5,1,9,2
9376,152,38,3682.4372296961537,3,4,4,11,1
9377,201,13,39.22292651311034,3,2,1,6,3
9378,128,42,2293.7313257632986,4,5,3,12,1
9379,287,44,3166.5341841687173,2,5,4,11,1
9380,311,24,2159.2470696906407,1,3,3,7,2
9381,253,32,639.7828297168589,2,4,1,7,2
9382,266,30,3893.4669320633247,2,3,4,9,2
9383,188,6,1626.4803219950725,3,1,2,6,3
9384,230,38,682.430200397846,2,4,1,7,2
9385,271,33,2755.826415584555,2,4,3,9,2
9386,259,44,105.666072244436,2,5,1,8,2
9387,299,23,1627.0778168172728,1,3,2,6,3
9388,198,10,3755.705424271071,3,1,4,8,2
9389,323,46,4564.42953352723,1,5,5,11,1
9390,56,15,2962.720022608035,5,2,3,10,1
9391,319,23,1095.8818111324365,1,3,2,6,3
9392,203,36,1107.8007520635908,3,4,2,9,2
9393,271,1,3023.3196044198626,2,1,3,6,3
9394,109,8,2039.7409171252611,4,1,3,8,2
9395,116,3,894.5488508917587,4,1,1,6,3
9396,92,14,3939.111227971865,4,2,4,10,1
9397,138,17,1009.2127521411404,4,2,1,7,2
9398,303,34,1614.9877648955087,1,4,2,7,2
9399,57,47,316.53289950274024,5,5,1,11,1
9400,50,6,3509.8468443822835,5,1,4,10,1
9401,71,5,1383.6368587347145,5,1,2,8,2
9402,82,46,1172.0061421182222,4,5,2,11,1
9403,105,41,1523.7578472510447,4,5,2,11,1
9404,88,40,4371.911359533812,4,4,5,13,0
9405,2,29,2594.912666659425,5,3,3,11,1
9406,360,35,797.844802037311,1,4,1,6,3
9407,84,18,3874.6596275505467,4,2,4,10,1
9408,43,40,1050.1816956911316,5,4,2,11,1
9409,154,48,2068.2559794659714,3,5,3,11,1
9410,327,30,2844.69833804683,1,3,3,7,2
9411,94,15,2926.370144501253,4,2,3,9,2
9412,298,15,354.47026137128415,1,2,1,4,3
9413,133,16,4185.654413598183,4,2,5,11,1
9414,65,33,2402.359492089932,5,4,3,12,1
9415,290,10,4946.410891592284,2,1,5,8,2
9416,257,19,3590.037615658485,2,2,4,8,2
9417,213,37,4962.918832376752,3,4,5,12,1
9418,148,3,2272.8414878448966,3,1,3,7,2
9419,61,36,712.4992221309832,5,4,1,10,1
9420,149,4,3639.2737913779383,3,1,4,8,2
9421,88,11,3891.0238095907507,4,2,4,10,1
9422,324,41,4265.647986733654,1,5,5,11,1
9423,278,33,1514.2306377754903,2,4,2,8,2
9424,82,28,2558.313080735482,4,3,3,10,1
9425,129,32,4288.952811068386,4,4,5,13,0
9426,286,16,4325.033820693377,2,2,5,9,2
9427,353,9,138.16237685014315,1,1,1,3,3
9428,280,11,3357.874752426923,2,2,4,8,2
9429,270,6,3012.4198743582015,2,1,3,6,3
9430,292,49,425.85550903241716,1,5,1,7,2
9431,203,27,4651.379036764678,3,3,5,11,1
9432,24,12,2232.4077462744267,5,2,3,10,1
9433,351,22,3374.5459735357526,1,3,4,8,2
9434,311,40,4415.160999560547,1,4,5,10,1
9435,208,48,659.3041436107862,3,5,1,9,2
9436,280,37,4280.657286088623,2,4,5,11,1
9437,205,21,3624.285092358473,3,3,4,10,1
9438,152,33,4199.565686566225,3,4,5,12,1
9439,26,17,2479.230168817614,5,2,3,10,1
9440,194,29,177.08941915334532,3,3,1,7,2
9441,336,40,3355.874060116053,1,4,4,9,2
9442,238,10,1878.9168178166715,2,1,2,5,3
9443,321,18,2018.0550134707898,1,2,3,6,3
9444,75,47,2211.8983855168394,4,5,3,12,1
9445,163,13,2469.6190825512704,3,2,3,8,2
9446,299,27,3313.051820504025,1,3,4,8,2
9447,29,10,3636.6106244968537,5,1,4,10,1
9448,165,32,3886.4430089445104,3,4,4,11,1
9449,337,41,3361.314893596343,1,5,4,10,1
9450,186,45,4019.3623054045106,3,5,5,13,0
9451,54,3,619.5245473740996,5,1,1,7,2
9452,295,22,4185.7201543272195,1,3,5,9,2
9453,42,27,1942.5226449257061,5,3,2,10,1
9454,285,3,2648.5956120622614,2,1,3,6,3
9455,138,33,2174.559208469481,4,4,3,11,1
9456,187,2,2383.828849996945,3,1,3,7,2
9457,204,11,1434.284148771122,3,2,2,7,2
9458,42,46,858.055044890367,5,5,1,11,1
9459,350,10,533.4247178859268,1,1,1,3,3
9460,288,39,2262.4802069496563,2,4,3,9,2
9461,26,33,635.052372794174,5,4,1,10,1
9462,56,7,1232.4924780142228,5,1,2,8,2
9463,253,15,676.7432692745639,2,2,1,5,3
9464,122,26,554.5149455606963,4,3,1,8,2
9465,106,11,4413.481127760279,4,2,5,11,1
9466,130,38,3373.3895055133344,4,4,4,12,1
9467,337,27,4619.5579682258995,1,3,5,9,2
9468,158,39,3223.620669582226,3,4,4,11,1
9469,231,7,4221.315609928898,2,1,5,8,2
9470,308,1,2780.939960455503,1,1,3,5,3
9471,91,10,2318.5239528693724,4,1,3,8,2
9472,22,21,2647.102231006951,5,3,3,11,1
9473,290,15,1607.925217439107,2,2,2,6,3
9474,110,30,3293.2822310590186,4,3,4,11,1
9475,49,30,4486.902759336694,5,3,5,13,0
9476,129,8,3913.9436979740735,4,1,4,9,2
9477,73,24,2315.3800535790538,5,3,3,11,1
9478,340,19,4770.056238276635,1,2,5,8,2
9479,53,3,4927.261239649368,5,1,5,11,1
9480,356,15,2470.5720425536997,1,2,3,6,3
9481,168,36,4324.552808150778,3,4,5,12,1
9482,45,6,33.80357832884313,5,1,1,7,2
9483,105,42,342.6114028159006,4,5,1,10,1
9484,150,48,121.72315055460193,3,5,1,9,2
9485,146,18,3868.08335676463,4,2,4,10,1
9486,204,38,408.0977661017422,3,4,1,8,2
9487,362,19,95.08222486025097,1,2,1,4,3
9488,299,49,745.6196790427451,1,5,1,7,2
9489,167,30,1538.4110085797329,3,3,2,8,2
9490,201,13,2328.8564026683102,3,2,3,8,2
9491,134,39,336.36239073342443,4,4,1,9,2
9492,211,12,2499.9213454191085,3,2,3,8,2
9493,48,34,1247.8266906125557,5,4,2,11,1
9494,126,12,1379.113760537135,4,2,2,8,2
9495,239,44,4111.292235722836,2,5,5,12,1
9496,7,24,4934.748644501168,5,3,5,13,0
9497,272,4,2324.6815060154718,2,1,3,6,3
9498,37,36,1615.635768820937,5,4,2,11,1
9499,211,48,4657.926399036248,3,5,5,13,0
9500,165,14,2507.237747866919,3,2,3,8,2
9501,125,17,3654.4643201917993,4,2,4,10,1
9502,337,49,2074.56275448982,1,5,3,9,2
9503,192,3,1020.7174025142158,3,1,1,5,3
9504,218,38,3277.876711712452,2,4,4,10,1
9505,214,23,3327.5648211882317,3,3,4,10,1
9506,62,13,2306.3174118939637,5,2,3,10,1
9507,328,9,1357.0486790533735,1,1,2,4,3
9508,161,21,4160.749325393116,3,3,5,11,1
9509,66,41,1383.837440684031,5,5,2,12,1
9510,286,8,3298.5296914712926,2,1,4,7,2
9511,239,17,1926.0882632245568,2,2,2,6,3
9512,20,16,2367.6785829092696,5,2,3,10,1
9513,188,16,1064.8992808873554,3,2,2,7,2
9514,82,28,3250.904927942033,4,3,4,11,1
9515,363,16,1136.8709097597323,1,2,2,5,3
9516,202,46,2433.713092571992,3,5,3,11,1
9517,132,46,1649.0123718005696,4,5,2,11,1
9518,37,14,4818.392606595262,5,2,5,12,1
9519,132,46,4911.2832685088015,4,5,5,14,0
9520,77,44,3769.9216236168377,4,5,4,13,0
9521,89,38,4919.748299325313,4,4,5,13,0
9522,253,20,576.617707610613,2,2,1,5,3
9523,344,45,4961.700023527112,1,5,5,11,1
9524,194,48,526.7440226905123,3,5,1,9,2
9525,176,41,2083.104350658647,3,5,3,11,1
9526,33,34,1202.3483750707237,5,4,2,11,1
9527,58,29,4769.691357391905,5,3,5,13,0
9528,201,3,3182.591774647716,3,1,4,8,2
9529,28,10,2989.6663937789745,5,1,3,9,2
9530,35,20,4987.21813938776,5,2,5,12,1
9531,125,2,3066.0062584148623,4,1,4,9,2
9532,321,27,3234.337805870809,1,3,4,8,2
9533,42,32,233.42375349082752,5,4,1,10,1
9534,85,10,4296.662504147352,4,1,5,10,1
9535,188,40,4850.7462643931985,3,4,5,12,1
9536,111,17,4801.952641113196,4,2,5,11,1
9537,271,33,1113.3169915949634,2,4,2,8,2
9538,325,6,1137.317566411094,1,1,2,4,3
9539,105,39,1836.5751548137591,4,4,2,10,1
9540,320,47,1557.948253878659,1,5,2,8,2
9541,41,18,1535.0170905135028,5,2,2,9,2
9542,215,9,3030.0314185041057,3,1,3,7,2
9543,71,8,4029.983954116379,5,1,5,11,1
9544,56,25,4684.473121766255,5,3,5,13,0
9545,236,31,348.6237881008884,2,4,1,7,2
9546,281,42,1397.1125971567344,2,5,2,9,2
9547,105,4,1282.5187294803452,4,1,2,7,2
9548,162,20,1793.6239212334474,3,2,2,7,2
9549,191,28,2127.4279729417094,3,3,3,9,2
9550,9,40,1951.9656437980782,5,4,2,11,1
9551,60,1,4761.2145748121875,5,1,5,11,1
9552,305,40,2191.2739898610853,1,4,3,8,2
9553,225,44,2762.446929713441,2,5,3,10,1
9554,307,23,3745.680069624674,1,3,4,8,2
9555,188,47,3628.1731369627423,3,5,4,12,1
9556,70,13,2918.9931878058983,5,2,3,10,1
9557,293,16,4305.551797260958,1,2,5,8,2
9558,287,26,3124.6647316147305,2,3,4,9,2
9559,169,31,4375.0466484691115,3,4,5,12,1
9560,62,1,1520.8010954066938,5,1,2,8,2
9561,349,17,668.7981477975446,1,2,1,4,3
9562,14,16,4099.407078180853,5,2,5,12,1
9563,164,37,1918.7643607947978,3,4,2,9,2
9564,245,10,3258.9120124897886,2,1,4,7,2
9565,335,38,3689.1828703832707,1,4,4,9,2
9566,8,44,1640.2852723819724,5,5,2,12,1
9567,154,31,2530.765308964495,3,4,3,10,1
9568,36,10,4475.6833105461255,5,1,5,11,1
9569,48,49,4400.168243839975,5,5,5,15,0
9570,85,34,3749.2918167886946,4,4,4,12,1
9571,28,6,3816.070264398077,5,1,4,10,1
9572,196,28,4489.445400915847,3,3,5,11,1
9573,208,28,3684.2986125766815,3,3,4,10,1
9574,204,13,1704.5309429244421,3,2,2,7,2
9575,307,41,612.705571403693,1,5,1,7,2
9576,104,12,2115.2016588739393,4,2,3,9,2
9577,230,40,445.8436451098449,2,4,1,7,2
9578,101,2,587.6961771840342,4,1,1,6,3
9579,29,8,4751.358743254482,5,1,5,11,1
9580,127,42,3382.675933406424,4,5,4,13,0
9581,338,9,4259.527415346793,1,1,5,7,2
9582,10,8,3218.0669744347183,5,1,4,10,1
9583,106,3,2098.514741716355,4,1,3,8,2
9584,167,9,135.542324483298,3,1,1,5,3
9585,257,13,4779.626814505436,2,2,5,9,2
9586,295,9,363.9530355423804,1,1,1,3,3
9587,277,31,3054.713699438965,2,4,4,10,1
9588,65,25,519.9940265352718,5,3,1,9,2
9589,271,44,1427.8969161619461,2,5,2,9,2
9590,188,45,937.2291119209857,3,5,1,9,2
9591,317,8,2773.047406642795,1,1,3,5,3
9592,138,47,4436.50597215928,4,5,5,14,0
9593,343,31,3181.7553159106033,1,4,4,9,2
9594,105,45,3324.29821733624,4,5,4,13,0
9595,34,45,4545.56816610438,5,5,5,15,0
9596,110,31,3749.6318875758157,4,4,4,12,1
9597,33,17,4331.119623556323,5,2,5,12,1
9598,354,47,2087.796538380728,1,5,3,9,2
9599,231,19,4328.128125482879,2,2,5,9,2
9600,317,3,3232.848328943564,1,1,4,6,3
9601,266,46,686.6828358792771,2,5,1,8,2
9602,182,30,203.17541675165972,3,3,1,7,2
9603,340,10,1227.731724292064,1,1,2,4,3
9604,65,49,1897.9647476451892,5,5,2,12,1
9605,333,29,4189.463651743476,1,3,5,9,2
9606,1,40,3708.8103395562302,5,4,4,13,0
9607,133,18,4777.324881756519,4,2,5,11,1
9608,80,12,2800.2822457450648,4,2,3,9,2
9609,271,49,3741.2308415238927,2,5,4,11,1
9610,241,23,1383.6640923606974,2,3,2,7,2
9611,28,11,3401.0936855475825,5,2,4,11,1
9612,223,9,3533.694500656068,2,1,4,7,2
9613,23,24,4243.5924888136105,5,3,5,13,0
9614,109,25,2686.653519266668,4,3,3,10,1
9615,107,25,3248.5356864999335,4,3,4,11,1
9616,145,47,1023.2135624234452,4,5,1,10,1
9617,354,9,3686.427859730992,1,1,4,6,3
9618,139,12,4193.674495974275,4,2,5,11,1
9619,284,11,2972.751353470218,2,2,3,7,2
9620,298,49,587.215567247249,1,5,1,7,2
9621,99,38,1571.1582079965956,4,4,2,10,1
9622,317,28,2382.818108546337,1,3,3,7,2
9623,123,8,3389.0403331001426,4,1,4,9,2
9624,320,10,1608.432268247475,1,1,2,4,3
9625,287,25,4203.0523461821795,2,3,5,10,1
9626,81,47,1865.2310589133638,4,5,2,11,1
9627,10,36,223.7533762553343,5,4,1,10,1
9628,8,43,3972.032139182477,5,5,4,14,0
9629,205,9,3224.6736158600957,3,1,4,8,2
9630,315,41,4011.7629087061814,1,5,4,10,1
9631,197,8,1750.9601682017985,3,1,2,6,3
9632,198,3,97.97465884170269,3,1,1,5,3
9633,30,18,378.0270890525614,5,2,1,8,2
9634,20,46,567.8858956971278,5,5,1,11,1
9635,48,35,4027.6864149969515,5,4,5,14,0
9636,130,17,1514.159424257185,4,2,2,8,2
9637,293,36,4989.513562018089,1,4,5,10,1
9638,132,28,3794.3580985194576,4,3,4,11,1
9639,356,15,3009.7632159202567,1,2,3,6,3
9640,54,19,4918.260865862159,5,2,5,12,1
9641,281,22,1588.3828496994242,2,3,2,7,2
9642,265,6,836.421689914644,2,1,1,4,3
9643,215,47,3688.9921185600633,3,5,4,12,1
9644,290,7,1397.6360601603117,2,1,2,5,3
9645,43,44,4805.5742710531185,5,5,5,15,0
9646,74,48,4940.465868128353,4,5,5,14,0
9647,350,9,4632.757931176516,1,1,5,7,2
9648,278,20,4724.361196918629,2,2,5,9,2
9649,326,37,3082.117538907636,1,4,4,9,2
9650,242,11,3463.672061347463,2,2,4,8,2
9651,130,2,480.2883272857451,4,1,1,6,3
9652,350,22,3817.6202970461572,1,3,4,8,2
9653,194,48,1018.2961817537032,3,5,1,9,2
9654,32,36,4203.22703792487,5,4,5,14,0
9655,106,5,4808.043784848897,4,1,5,10,1
9656,204,7,1069.764369535712,3,1,2,6,3
9657,1,6,399.3752768520504,5,1,1,7,2
9658,245,22,2424.6117949467703,2,3,3,8,2
9659,72,10,3959.8313660220624,5,1,4,10,1
9660,306,46,3855.4944480181794,1,5,4,10,1
9661,15,40,3487.124343226355,5,4,4,13,0
9662,53,46,4105.2729912713585,5,5,5,15,0
9663,8,46,883.1918794498118,5,5,1,11,1
9664,330,20,3263.1694118508703,1,2,4,7,2
9665,46,28,3032.3397863292726,5,3,3,11,1
9666,325,23,775.6243015608688,1,3,1,5,3
9667,114,35,2077.9910824863528,4,4,3,11,1
9668,147,1,4264.123299354642,3,1,5,9,2
9669,166,29,4859.291002200318,3,3,5,11,1
9670,139,9,3330.4965861109854,4,1,4,9,2
9671,117,9,4610.48579951136,4,1,5,10,1
9672,299,22,668.9256606112525,1,3,1,5,3
9673,276,2,4875.552022958306,2,1,5,8,2
9674,277,16,177.1974309117602,2,2,1,5,3
9675,338,40,2641.0237746207963,1,4,3,8,2
9676,313,6,1462.1315640593873,1,1,2,4,3
9677,178,13,4071.4064428561987,3,2,5,10,1
9678,330,33,1095.5427241665784,1,4,2,7,2
9679,354,19,67.53488329836259,1,2,1,4,3
9680,154,15,2078.901201588604,3,2,3,8,2
9681,201,33,329.8989083555596,3,4,1,8,2
9682,115,10,1457.5619202468679,4,1,2,7,2
9683,159,1,3222.300981416824,3,1,4,8,2
9684,42,12,1480.5688513166642,5,2,2,9,2
9685,247,43,1236.508204332951,2,5,2,9,2
9686,68,29,785.9233587209944,5,3,1,9,2
9687,326,17,684.5096476817466,1,2,1,4,3
9688,334,4,2634.028292175282,1,1,3,5,3
9689,196,29,3410.720044487922,3,3,4,10,1
9690,90,7,2269.1386966208215,4,1,3,8,2
9691,111,44,626.7794642487739,4,5,1,10,1
9692,359,13,3242.303934612416,1,2,4,7,2
9693,145,5,2790.0382726249745,4,1,3,8,2
9694,275,6,1912.5645217745807,2,1,2,5,3
9695,179,34,1656.9339168588076,3,4,2,9,2
9696,241,7,923.9329268392086,2,1,1,4,3
9697,326,46,740.0342995689699,1,5,1,7,2
9698,319,28,1700.4707553988098,1,3,2,6,3
9699,331,46,217.73930927624176,1,5,1,7,2
9700,153,10,2188.770789878524,3,1,3,7,2
9701,104,4,3011.85390713183,4,1,3,8,2
9702,75,3,4708.854833711524,4,1,5,10,1
9703,128,25,3132.882434955908,4,3,4,11,1
9704,199,23,3124.1394738109398,3,3,4,10,1
9705,154,27,1878.329879961992,3,3,2,8,2
9706,56,14,675.252609842444,5,2,1,8,2
9707,278,38,2240.2188897466526,2,4,3,9,2
9708,345,32,2997.3948321468947,1,4,3,8,2
9709,19,23,3622.927647312462,5,3,4,12,1
9710,159,47,4132.1730017382,3,5,5,13,0
9711,26,40,1287.0811794199262,5,4,2,11,1
9712,169,37,1213.6881753871585,3,4,2,9,2
9713,23,3,2830.846316891545,5,1,3,9,2
9714,47,35,2834.4157638408024,5,4,3,12,1
9715,13,13,1097.5595055468439,5,2,2,9,2
9716,217,34,2941.501798652853,3,4,3,10,1
9717,322,24,1735.9354613722305,1,3,2,6,3
9718,194,1,3200.181445204378,3,1,4,8,2
9719,144,12,1462.313121224286,4,2,2,8,2
9720,73,8,2965.5360424371665,5,1,3,9,2
9721,156,19,3843.867105772246,3,2,4,9,2
9722,77,9,4900.99229075267,4,1,5,10,1
9723,169,28,4556.229601794069,3,3,5,11,1
9724,287,14,2522.658349163987,2,2,3,7,2
9725,85,27,2446.861925754914,4,3,3,10,1
9726,182,18,2194.123029619386,3,2,3,8,2
9727,315,42,148.4754839633058,1,5,1,7,2
9728,297,41,838.1129424564458,1,5,1,7,2
9729,112,6,305.35355063723836,4,1,1,6,3
9730,230,33,3484.811873028851,2,4,4,10,1
9731,96,37,2072.040904588646,4,4,3,11,1
9732,168,42,328.21169154639375,3,5,1,9,2
9733,156,25,3455.9696374928117,3,3,4,10,1
9734,105,13,3225.7349555114397,4,2,4,10,1
9735,193,23,3602.614525145581,3,3,4,10,1
9736,330,36,3003.1722476302302,1,4,3,8,2
9737,132,33,816.0824041369476,4,4,1,9,2
9738,355,21,316.34756573342236,1,3,1,5,3
9739,138,34,4087.533441432916,4,4,5,13,0
9740,331,36,1086.8869048396714,1,4,2,7,2
9741,270,17,2717.2209099661727,2,2,3,7,2
9742,38,10,2431.232903513614,5,1,3,9,2
9743,45,23,4606.052176778206,5,3,5,13,0
9744,163,44,2766.674406662949,3,5,3,11,1
9745,331,2,2904.284258081882,1,1,3,5,3
9746,253,35,1604.3301182419057,2,4,2,8,2
9747,169,14,4793.8865618256195,3,2,5,10,1
9748,285,47,3065.745340538781,2,5,4,11,1
9749,274,45,34.85211412037779,2,5,1,8,2
9750,20,41,2784.8504960374667,5,5,3,13,0
9751,239,2,1825.688287642954,2,1,2,5,3
9752,270,19,170.23989945117276,2,2,1,5,3
9753,310,16,2163.4334296803513,1,2,3,6,3
9754,31,43,3870.0967770093625,5,5,4,14,0
9755,314,44,2523.9093952022486,1,5,3,9,2
9756,104,25,3200.9008398385736,4,3,4,11,1
9757,170,1,3202.3099139443816,3,1,4,8,2
9758,186,2,3358.3863193923003,3,1,4,8,2
9759,128,48,1944.1050108971913,4,5,2,11,1
9760,210,27,1856.3241468936565,3,3,2,8,2
9761,281,2,32.87681141292353,2,1,1,4,3
9762,253,30,779.5700780393162,2,3,1,6,3
9763,19,10,4754.542961779943,5,1,5,11,1
9764,200,19,4213.659411783166,3,2,5,10,1
9765,220,42,1382.791102575616,2,5,2,9,2
9766,136,16,2011.9478251396583,4,2,3,9,2
9767,223,13,4700.207403689318,2,2,5,9,2
9768,3,48,1259.71795297235,5,5,2,12,1
9769,236,8,2667.33951675176,2,1,3,6,3
9770,342,31,120.17812243646875,1,4,1,6,3
9771,228,45,3102.476833400505,2,5,4,11,1
9772,142,25,4651.067254890231,4,3,5,12,1
9773,9,39,4424.869490351711,5,4,5,14,0
9774,190,21,2514.826410931391,3,3,3,9,2
9775,350,38,3251.713441663058,1,4,4,9,2
9776,165,41,2853.2929881262944,3,5,3,11,1
9777,139,29,344.2014783293358,4,3,1,8,2
9778,276,6,802.0301995149619,2,1,1,4,3
9779,291,18,4819.4484007011015,2,2,5,9,2
9780,53,49,1287.2837973896494,5,5,2,12,1
9781,175,44,1928.401588321033,3,5,2,10,1
9782,110,35,2549.6320966929907,4,4,3,11,1
9783,203,27,4895.869325672774,3,3,5,11,1
9784,136,5,3453.0675960865847,4,1,4,9,2
9785,4,7,3151.696503674523,5,1,4,10,1
9786,155,10,2626.755862479888,3,1,3,7,2
9787,172,10,3506.36532882684,3,1,4,8,2
9788,358,28,3323.4392937364496,1,3,4,8,2
9789,47,36,4515.1760523823,5,4,5,14,0
9790,94,10,2713.7581737694672,4,1,3,8,2
9791,48,35,2113.297915070544,5,4,3,12,1
9792,240,35,4037.7385200387175,2,4,5,11,1
9793,347,37,4000.918840087224,1,4,4,9,2
9794,213,48,857.4838256803165,3,5,1,9,2
9795,340,20,1191.5920693037137,1,2,2,5,3
9796,324,13,4793.604923885532,1,2,5,8,2
9797,139,11,2226.1065965281,4,2,3,9,2
9798,205,45,2603.106875690636,3,5,3,11,1
9799,73,19,1557.6990216532508,5,2,2,9,2
9800,4,28,2410.5444042577938,5,3,3,11,1
9801,76,38,3719.349469906323,4,4,4,12,1
9802,329,45,2416.9020363437394,1,5,3,9,2
9803,77,4,1580.7755529937394,4,1,2,7,2
9804,304,37,489.0450119279389,1,4,1,6,3
9805,256,19,4642.0249874825795,2,2,5,9,2
9806,102,37,4359.572535781459,4,4,5,13,0
9807,106,14,3958.9110673151135,4,2,4,10,1
9808,333,31,3473.4141095744,1,4,4,9,2
9809,39,28,2582.3943234084113,5,3,3,11,1
9810,314,36,4488.009962751027,1,4,5,10,1
9811,275,44,3960.590548857279,2,5,4,11,1
9812,88,38,4081.8941007040685,4,4,5,13,0
9813,211,19,1554.6568602673376,3,2,2,7,2
9814,77,42,2123.0567842779674,4,5,3,12,1
9815,77,1,3536.94329797506,4,1,4,9,2
9816,28,23,1861.6008930066914,5,3,2,10,1
9817,245,28,2474.93351984465,2,3,3,8,2
9818,66,48,3236.099708848566,5,5,4,14,0
9819,266,4,2194.414423905562,2,1,3,6,3
9820,205,41,3967.2676397428204,3,5,4,12,1
9821,58,18,590.2314060337296,5,2,1,8,2
9822,201,49,3593.101983812266,3,5,4,12,1
9823,225,47,734.598202450277,2,5,1,8,2
9824,142,39,4689.819878093344,4,4,5,13,0
9825,84,25,1577.0480266678442,4,3,2,9,2
9826,143,18,3979.207481586961,4,2,4,10,1
9827,352,6,2611.8707207622933,1,1,3,5,3
9828,33,19,464.5244622734919,5,2,1,8,2
9829,152,12,2917.108403411587,3,2,3,8,2
9830,158,25,4561.766907044023,3,3,5,11,1
9831,141,35,794.5996781451406,4,4,1,9,2
9832,251,1,1613.3216773105503,2,1,2,5,3
9833,303,5,2201.4017680791235,1,1,3,5,3
9834,112,1,1382.514786069862,4,1,2,7,2
9835,144,8,4719.459578934441,4,1,5,10,1
9836,209,39,1893.726321394243,3,4,2,9,2
9837,224,47,3293.7296718435364,2,5,4,11,1
9838,43,43,1127.344654206629,5,5,2,12,1
9839,264,18,1106.3326280334247,2,2,2,6,3
9840,244,46,887.4881846636562,2,5,1,8,2
9841,3,9,2179.713194998349,5,1,3,9,2
9842,125,5,2668.9624294273694,4,1,3,8,2
9843,268,4,63.633347100393046,2,1,1,4,3
9844,84,44,4166.287903789442,4,5,5,14,0
9845,16,29,2568.641923730183,5,3,3,11,1
9846,334,1,794.4775178479958,1,1,1,3,3
9847,59,30,345.7936293899139,5,3,1,9,2
9848,177,45,325.3644926753469,3,5,1,9,2
9849,63,1,1295.6409994240598,5,1,2,8,2
9850,49,3,2501.4678183751844,5,1,3,9,2
9851,307,22,4302.595284654962,1,3,5,9,2
9852,246,8,4515.797480185609,2,1,5,8,2
9853,289,18,4163.316320697226,2,2,5,9,2
9854,286,25,1649.5317059224112,2,3,2,7,2
9855,332,48,1539.7231810134356,1,5,2,8,2
9856,15,20,4937.417142323438,5,2,5,12,1
9857,338,31,3409.5903436374197,1,4,4,9,2
9858,255,30,1531.7101868751333,2,3,2,7,2
9859,92,16,1652.1099601007693,4,2,2,8,2
9860,279,2,2178.875752160378,2,1,3,6,3
9861,206,17,3112.815422145939,3,2,4,9,2
9862,94,10,4490.916008258678,4,1,5,10,1
9863,225,7,999.5525272850821,2,1,1,4,3
9864,301,42,431.1729544454683,1,5,1,7,2
9865,318,9,2034.7030985316203,1,1,3,5,3
9866,199,17,1234.8228582267773,3,2,2,7,2
9867,271,9,2884.403040461126,2,1,3,6,3
9868,234,9,3499.0820373656334,2,1,4,7,2
9869,46,37,1560.5724090499752,5,4,2,11,1
9870,64,24,3430.401931421323,5,3,4,12,1
9871,230,39,1722.304801740455,2,4,2,8,2
9872,249,11,3178.4910169346476,2,2,4,8,2
9873,246,8,3168.973425669525,2,1,4,7,2
9874,75,25,1398.0169200740024,4,3,2,9,2
9875,157,46,3182.2565310339155,3,5,4,12,1
9876,223,2,1910.9659276610425,2,1,2,5,3
9877,190,10,1688.9101723597196,3,1,2,6,3
9878,52,24,1453.5458578617981,5,3,2,10,1
9879,88,48,1734.769848070102,4,5,2,11,1
9880,313,16,3935.8570113851283,1,2,4,7,2
9881,339,19,1233.4422827208607,1,2,2,5,3
9882,66,31,3413.1171516800855,5,4,4,13,0
9883,150,11,4504.096719054692,3,2,5,10,1
9884,20,6,1758.640415762465,5,1,2,8,2
9885,33,6,157.265201829553,5,1,1,7,2
9886,328,32,132.7840853337006,1,4,1,6,3
9887,281,39,706.1194128680186,2,4,1,7,2
9888,46,48,559.1237670623412,5,5,1,11,1
9889,73,13,3742.9453968584517,5,2,4,11,1
9890,354,3,1481.3050773677894,1,1,2,4,3
9891,313,41,3266.0237702674144,1,5,4,10,1
9892,343,35,221.85262426956487,1,4,1,6,3
9893,133,38,1485.7439776299314,4,4,2,10,1
9894,55,17,1178.3897110396294,5,2,2,9,2
9895,61,3,1391.6337466582904,5,1,2,8,2
9896,345,34,961.6816679776592,1,4,1,6,3
9897,8,12,3093.4009453005756,5,2,4,11,1
9898,272,24,3316.7376195867673,2,3,4,9,2
9899,246,6,750.8427975114689,2,1,1,4,3
9900,176,42,3708.318463227641,3,5,4,12,1
9901,116,11,1257.7269265305583,4,2,2,8,2
9902,317,48,1421.7832874728315,1,5,2,8,2
9903,271,27,4145.753610829676,2,3,5,10,1
9904,193,48,4506.817917203249,3,5,5,13,0
9905,150,24,4125.534004207432,3,3,5,11,1
9906,131,18,747.3364735511364,4,2,1,7,2
9907,102,27,4996.345499131633,4,3,5,12,1
9908,310,41,3364.055519764018,1,5,4,10,1
9909,270,21,2558.236421488113,2,3,3,8,2
9910,292,34,4774.658624689644,1,4,5,10,1
9911,210,33,4088.7281731787016,3,4,5,12,1
9912,361,48,3461.7977677473964,1,5,4,10,1
9913,338,18,4193.602269925845,1,2,5,8,2
9914,67,3,1933.4782505568514,5,1,2,8,2
9915,10,24,3425.3478427466653,5,3,4,12,1
9916,49,1,960.9942934615425,5,1,1,7,2
9917,111,6,4940.1231699828395,4,1,5,10,1
9918,321,19,2949.018683466083,1,2,3,6,3
9919,219,22,4073.0438647021842,2,3,5,10,1
9920,57,43,2042.6260038498597,5,5,3,13,0
9921,283,8,3795.358208183152,2,1,4,7,2
9922,113,5,1943.050648352109,4,1,2,7,2
9923,133,9,2954.1253839333085,4,1,3,8,2
9924,71,47,3892.8927302746974,5,5,4,14,0
9925,83,21,591.2048273482305,4,3,1,8,2
9926,57,28,1790.3613983345447,5,3,2,10,1
9927,349,46,2729.2353753907237,1,5,3,9,2
9928,271,4,1676.6485533799646,2,1,2,5,3
9929,111,24,1552.7445014307373,4,3,2,9,2
9930,357,8,1415.5038070177336,1,1,2,4,3
9931,76,17,1146.681190828714,4,2,2,8,2
9932,158,34,4246.033767152597,3,4,5,12,1
9933,20,20,4619.208755708956,5,2,5,12,1
9934,131,16,3503.8455463000773,4,2,4,10,1
9935,329,10,159.6975686977329,1,1,1,3,3
9936,122,34,3933.3036436937196,4,4,4,12,1
9937,41,43,2664.379807165673,5,5,3,13,0
9938,167,10,3792.969338539195,3,1,4,8,2
9939,130,30,2192.31848457752,4,3,3,10,1
9940,23,30,215.99675529371402,5,3,1,9,2
9941,279,25,3411.907479525222,2,3,4,9,2
9942,251,46,2226.2011777183457,2,5,3,10,1
9943,9,43,4371.47704277078,5,5,5,15,0
9944,13,41,3693.3083047389227,5,5,4,14,0
9945,307,7,1804.2131214112687,1,1,2,4,3
9946,320,47,3623.168979321255,1,5,4,10,1
9947,52,20,2481.0909112531585,5,2,3,10,1
9948,209,17,1005.2253217751303,3,2,1,6,3
9949,38,3,2105.232734006707,5,1,3,9,2
9950,100,47,1120.586348598143,4,5,2,11,1
9951,193,46,34.83283449250178,3,5,1,9,2
9952,191,40,1241.5109102098384,3,4,2,9,2
9953,51,36,1055.5114162821692,5,4,2,11,1
9954,141,26,31.641174347638525,4,3,1,8,2
9955,168,10,3921.787586820087,3,1,4,8,2
9956,311,34,394.15484147255233,1,4,1,6,3
9957,109,14,2250.804778955022,4,2,3,9,2
9958,207,8,2095.237046728354,3,1,3,7,2
9959,300,27,915.2265053546621,1,3,1,5,3
9960,110,10,4834.6738476215305,4,1,5,10,1
9961,196,15,3022.630688585023,3,2,3,8,2
9962,152,37,4069.4300981669307,3,4,5,12,1
9963,243,22,2485.7413806024015,2,3,3,8,2
9964,128,45,3616.8314676908362,4,5,4,13,0
9965,105,31,4849.198249475672,4,4,5,13,0
9966,10,2,1748.5430148774767,5,1,2,8,2
9967,356,45,2526.2766250226277,1,5,3,9,2
9968,148,31,2577.5391244731127,3,4,3,10,1
9969,364,14,4960.054133457452,1,2,5,8,2
9970,140,10,1173.1647404971432,4,1,2,7,2
9971,190,30,3379.784467849523,3,3,4,10,1
9972,94,36,699.7660954939048,4,4,1,9,2
9973,229,47,4636.096924950698,2,5,5,12,1
9974,63,40,2956.0057758184753,5,4,3,12,1
9975,340,15,4298.463519926956,1,2,5,8,2
9976,25,14,4477.255306254143,5,2,5,12,1
9977,268,31,2789.9784613996967,2,4,3,9,2
9978,281,29,3413.21628347861,2,3,4,9,2
9979,11,27,3496.615993744263,5,3,4,12,1
9980,320,21,2307.799309308706,1,3,3,7,2
9981,201,9,2179.8428540402974,3,1,3,7,2
9982,126,20,939.0792127009329,4,2,1,7,2
9983,306,35,1925.733656901034,1,4,2,7,2
9984,190,15,4953.8771333223185,3,2,5,10,1
9985,89,24,1356.6092698212447,4,3,2,9,2
9986,355,49,3814.580134293758,1,5,4,10,1
9987,116,16,306.1438755826274,4,2,1,7,2
9988,352,36,2342.6692990642146,1,4,3,8,2
9989,177,11,301.4665582665566,3,2,1,6,3
9990,14,8,2384.241669701413,5,1,3,9,2
9991,257,3,147.48677943879073,2,1,1,4,3
9992,209,19,3070.340909704685,3,2,4,9,2
9993,281,46,2936.6804088946133,2,5,3,10,1
9994,328,41,3991.237680925474,1,5,4,10,1
9995,325,3,2920.598148984722,1,1,3,5,3
9996,105,36,4630.735820131856,4,4,5,13,0
9997,147,25,3917.692024231037,3,3,4,10,1
9998,279,36,671.9560364082239,2,4,1,7,2
9999,9,11,1334.7112096473936,5,2,2,9,2
10000,118,16,140.89068286627983,4,2,1,7,2
10001,94,17,1936.8086678483085,4,2,2,8,2
10002,144,42,2552.5859063095572,4,5,3,12,1
10003,289,24,4730.271781422512,2,3,5,10,1
10004,14,17,2616.1144870862736,5,2,3,10,1
10005,257,48,3907.329929295305,2,5,4,11,1
10006,346,20,1347.4398228385771,1,2,2,5,3
10007,186,22,774.2606019215702,3,3,1,7,2
10008,345,6,4056.0729065930013,1,1,5,7,2
10009,207,7,1244.651475419211,3,1,2,6,3
10010,346,14,4357.962237178821,1,2,5,8,2
10011,172,11,857.5508797028958,3,2,1,6,3
10012,270,12,4259.416839665384,2,2,5,9,2
10013,221,46,3866.509424571506,2,5,4,11,1
10014,152,5,3059.991158971613,3,1,4,8,2
10015,111,5,4252.6011823348545,4,1,5,10,1
10016,183,20,1660.243488233483,3,2,2,7,2
10017,339,15,838.510386870285,1,2,1,4,3
10018,72,26,793.6329687712335,5,3,1,9,2
10019,283,33,1359.0909799403635,2,4,2,8,2
10020,74,30,2236.6733895784637,4,3,3,10,1
10021,355,24,4381.354096755322,1,3,5,9,2
10022,215,23,456.7829042671052,3,3,1,7,2
10023,328,9,4577.0578017294,1,1,5,7,2
10024,23,3,4628.21860459703,5,1,5,11,1
10025,68,36,3638.909589439774,5,4,4,13,0
10026,362,48,4502.415231993474,1,5,5,11,1
10027,93,7,3852.2332845880314,4,1,4,9,2
10028,321,22,2646.221816127211,1,3,3,7,2
10029,324,14,3007.743628867462,1,2,3,6,3
10030,63,48,3144.8401376231377,5,5,4,14,0
10031,224,29,643.1974721057235,2,3,1,6,3
10032,225,16,973.3401462123771,2,2,1,5,3
10033,346,48,2621.609932112103,1,5,3,9,2
10034,337,34,584.9892807269996,1,4,1,6,3
10035,103,10,4825.246687270094,4,1,5,10,1
10036,215,7,2540.565119786964,3,1,3,7,2
10037,192,25,1906.6298626171672,3,3,2,8,2
10038,160,27,796.1247875818805,3,3,1,7,2
10039,207,15,2088.50414840118,3,2,3,8,2
10040,269,32,1519.1066730928187,2,4,2,8,2
10041,194,28,448.75658429815286,3,3,1,7,2
10042,152,9,4835.356423237727,3,1,5,9,2
10043,237,7,1332.240699284244,2,1,2,5,3
10044,88,16,3455.446508246286,4,2,4,10,1
10045,11,26,465.6992840938895,5,3,1,9,2
10046,187,35,4566.713356540595,3,4,5,12,1
10047,214,17,2957.849743287279,3,2,3,8,2
10048,15,23,3287.7912818792943,5,3,4,12,1
10049,266,8,3911.103959737654,2,1,4,7,2
10050,297,2,3033.517490038767,1,1,3,5,3
10051,73,31,363.8282174821456,5,4,1,10,1
10052,52,32,2153.6162939244414,5,4,3,12,1
10053,128,29,1317.530165722412,4,3,2,9,2
10054,28,3,2438.7179331991074,5,1,3,9,2
10055,65,8,2027.5825567918728,5,1,3,9,2
10056,17,2,4134.4002553212495,5,1,5,11,1
10057,351,31,1242.767285526757,1,4,2,7,2
10058,138,49,1014.4922857969625,4,5,1,10,1
10059,319,37,4790.850614298369,1,4,5,10,1
10060,229,20,4748.087903307006,2,2,5,9,2
10061,254,29,4967.39017493883,2,3,5,10,1
10062,210,17,2846.2190919362224,3,2,3,8,2
10063,294,10,574.5883633391028,1,1,1,3,3
10064,231,41,4402.037026278614,2,5,5,12,1
10065,241,22,734.1237714456265,2,3,1,6,3
10066,70,6,786.4156868854891,5,1,1,7,2
10067,104,43,975.0538617555789,4,5,1,10,1
10068,204,34,3270.5599886115333,3,4,4,11,1
10069,53,31,544.9232756043392,5,4,1,10,1
10070,330,12,3893.6253287687123,1,2,4,7,2
10071,54,12,300.6754638306904,5,2,1,8,2
10072,276,16,561.1283377523824,2,2,1,5,3
10073,335,25,2178.0908369159774,1,3,3,7,2
10074,31,22,1902.0657947300044,5,3,2,10,1
10075,135,27,4948.644259303195,4,3,5,12,1
10076,58,24,4834.651144026329,5,3,5,13,0
10077,105,12,956.5122187045715,4,2,1,7,2
10078,266,18,4733.8610699415285,2,2,5,9,2
10079,10,45,3464.386901019711,5,5,4,14,0
10080,253,47,2050.1273960108374,2,5,3,10,1
10081,295,16,3700.758351483097,1,2,4,7,2
10082,156,4,4501.703418875669,3,1,5,9,2
10083,158,12,908.9063534568853,3,2,1,6,3
10084,37,49,987.961464274529,5,5,1,11,1
10085,119,33,2049.5166035160255,4,4,3,11,1
10086,67,22,854.3667389620028,5,3,1,9,2
10087,242,18,1808.3834536720206,2,2,2,6,3
10088,299,48,3232.0007200419454,1,5,4,10,1
10089,213,33,4065.9624454159352,3,4,5,12,1
10090,308,27,1516.6553390501433,1,3,2,6,3
10091,101,42,1415.8361121861417,4,5,2,11,1
10092,56,19,3900.917392301996,5,2,4,11,1
10093,332,48,1911.3208677525206,1,5,2,8,2
10094,324,14,4094.192085665519,1,2,5,8,2
10095,239,25,4966.967798442774,2,3,5,10,1
10096,231,34,4898.546693158748,2,4,5,11,1
10097,362,24,3316.807904687972,1,3,4,8,2
10098,92,38,1882.3139247734782,4,4,2,10,1
10099,279,23,336.7943987890457,2,3,1,6,3
10100,109,5,3692.822757258133,4,1,4,9,2
10101,317,44,4890.056532855688,1,5,5,11,1
10102,168,36,349.24247144598434,3,4,1,8,2
10103,300,24,40.77687599699431,1,3,1,5,3
10104,218,36,4160.56322094277,2,4,5,11,1
10105,222,5,520.2722205708034,2,1,1,4,3
10106,161,39,417.2986724234416,3,4,1,8,2
10107,16,6,4552.576980433661,5,1,5,11,1
10108,278,45,407.0084502426879,2,5,1,8,2
10109,57,36,578.9480973293764,5,4,1,10,1
10110,62,45,2852.1726395957694,5,5,3,13,0
10111,363,4,3786.5027234361232,1,1,4,6,3
10112,327,10,2003.8655709839936,1,1,2,4,3
10113,242,1,2108.739911845048,2,1,3,6,3
10114,90,21,3166.8036758841818,4,3,4,11,1
10115,72,40,2532.0722212055985,5,4,3,12,1
10116,326,39,102.95518096081028,1,4,1,6,3
10117,30,37,576.7800994982774,5,4,1,10,1
10118,359,3,2912.18407747176,1,1,3,5,3
10119,288,47,3970.375923392352,2,5,4,11,1
10120,86,31,3817.8846956954803,4,4,4,12,1
10121,234,27,3702.8822308752888,2,3,4,9,2
10122,235,17,3858.650354878589,2,2,4,8,2
10123,313,23,231.77294685937005,1,3,1,5,3
10124,265,13,4476.556809163317,2,2,5,9,2
10125,287,47,4447.522695006256,2,5,5,12,1
10126,327,27,2664.300705597094,1,3,3,7,2
10127,269,20,1250.4857180211393,2,2,2,6,3
10128,186,46,2964.9705791793526,3,5,3,11,1
10129,131,13,2793.85077261268,4,2,3,9,2
10130,291,44,1122.5564663741495,2,5,2,9,2
10131,277,24,3019.619592854059,2,3,3,8,2
10132,320,41,3988.4976393420425,1,5,4,10,1
10133,351,3,4032.473255078828,1,1,5,7,2
10134,180,43,307.89213317677275,3,5,1,9,2
10135,290,10,993.8449259441973,2,1,1,4,3
10136,163,1,3344.4345693600453,3,1,4,8,2
10137,271,49,4300.561407617368,2,5,5,12,1
10138,96,13,2610.873241421585,4,2,3,9,2
10139,262,14,3540.553084991552,2,2,4,8,2
10140,353,33,115.14933317793381,1,4,1,6,3
10141,288,2,3046.0198513081427,2,1,4,7,2
10142,83,2,4809.926630738642,4,1,5,10,1
10143,225,39,3308.4628890933623,2,4,4,10,1
10144,223,41,4612.155825835595,2,5,5,12,1
10145,118,31,2834.387196074058,4,4,3,11,1
10146,192,4,4218.459901501879,3,1,5,9,2
10147,79,34,629.5704172031661,4,4,1,9,2
10148,78,19,626.3311818052144,4,2,1,7,2
10149,147,37,609.6948526870148,3,4,1,8,2
10150,107,9,2449.3592646631782,4,1,3,8,2
10151,271,24,1658.0151685772041,2,3,2,7,2
10152,244,13,3598.737410167769,2,2,4,8,2
10153,73,44,4514.083352358982,5,5,5,15,0
10154,357,30,3100.6803945816746,1,3,4,8,2
10155,354,19,1073.9206749319108,1,2,2,5,3
10156,26,41,4655.075568970277,5,5,5,15,0
10157,210,10,2644.008117308533,3,1,3,7,2
10158,92,42,3602.528310147419,4,5,4,13,0
10159,125,44,4453.624193671534,4,5,5,14,0
10160,73,14,4949.261341173524,5,2,5,12,1
10161,123,40,2535.2591060173527,4,4,3,11,1
10162,309,48,4042.2329662315324,1,5,5,11,1
10163,184,49,2838.666655938028,3,5,3,11,1
10164,187,20,2437.4051905190718,3,2,3,8,2
10165,198,4,2693.1854711886863,3,1,3,7,2
10166,78,38,2426.533466670304,4,4,3,11,1
10167,348,44,2110.9303127854564,1,5,3,9,2
10168,186,39,3621.366245664799,3,4,4,11,1
10169,344,5,1255.8823215788193,1,1,2,4,3
10170,253,42,3085.743514371943,2,5,4,11,1
10171,13,32,3567.6712870445035,5,4,4,13,0
10172,299,6,4461.533258619618,1,1,5,7,2
10173,76,14,1666.0669731985527,4,2,2,8,2
10174,51,6,4304.389526545161,5,1,5,11,1
10175,275,14,4727.00294491606,2,2,5,9,2
10176,149,12,3246.910119881177,3,2,4,9,2
10177,219,27,3859.4507095358354,2,3,4,9,2
10178,122,26,2034.4777294961782,4,3,3,10,1
10179,211,12,4761.155744725616,3,2,5,10,1
10180,280,8,3357.5986608812564,2,1,4,7,2
10181,26,10,1557.6824750026599,5,1,2,8,2
10182,173,16,2027.264122697774,3,2,3,8,2
10183,156,26,3092.600015516565,3,3,4,10,1
10184,238,8,1178.3344709163525,2,1,2,5,3
10185,82,41,3772.0328776580577,4,5,4,13,0
10186,356,45,1131.2106661855191,1,5,2,8,2
10187,273,29,2963.0280868969867,2,3,3,8,2
10188,68,20,3488.062499844188,5,2,4,11,1
10189,44,17,4300.141999351078,5,2,5,12,1
10190,61,19,3672.1630747867766,5,2,4,11,1
10191,123,17,3996.1372068459023,4,2,4,10,1
10192,349,39,4565.529689474262,1,4,5,10,1
10193,196,1,2992.880090498141,3,1,3,7,2
10194,330,29,4232.937253203463,1,3,5,9,2
10195,323,14,1167.0424328156087,1,2,2,5,3
10196,111,17,4075.518522251945,4,2,5,11,1
10197,258,13,1116.2168391193366,2,2,2,6,3
10198,89,29,4673.799801526471,4,3,5,12,1
10199,198,34,1656.5669539137666,3,4,2,9,2
10200,282,27,867.4716108963081,2,3,1,6,3
10201,200,46,749.3621130447174,3,5,1,9,2
10202,99,33,944.4883625197834,4,4,1,9,2
10203,27,29,2243.226139730198,5,3,3,11,1
10204,89,37,2615.5254614894943,4,4,3,11,1
10205,146,39,4569.791304294354,4,4,5,13,0
10206,182,19,1911.2638666092007,3,2,2,7,2
10207,257,46,1095.2367208474,2,5,2,9,2
10208,189,24,3721.6673480785144,3,3,4,10,1
10209,240,14,681.9254955637437,2,2,1,5,3
10210,359,47,4462.494026355787,1,5,5,11,1
10211,196,37,2052.904179691932,3,4,3,10,1
10212,297,5,3073.069003438349,1,1,4,6,3
10213,165,24,939.0598696564479,3,3,1,7,2
10214,307,34,736.1904539083852,1,4,1,6,3
10215,271,31,3996.2084800267294,2,4,4,10,1
10216,8,30,2154.214436653654,5,3,3,11,1
10217,38,9,4933.846635503789,5,1,5,11,1
10218,114,27,2626.2467428177333,4,3,3,10,1
10219,339,28,4229.808024680871,1,3,5,9,2
10220,56,42,4900.018756819962,5,5,5,15,0
10221,359,26,1412.939305927423,1,3,2,6,3
10222,138,18,4006.399743655277,4,2,4,10,1
10223,102,36,119.81075498998354,4,4,1,9,2
10224,334,8,3401.9730491245336,1,1,4,6,3
10225,177,18,3728.5534446780684,3,2,4,9,2
10226,169,20,2392.044925053157,3,2,3,8,2
10227,339,32,818.904998486335,1,4,1,6,3
10228,286,29,3087.4355349114644,2,3,4,9,2
10229,261,49,4488.668010583432,2,5,5,12,1
10230,223,48,4657.282805895562,2,5,5,12,1
10231,199,18,3733.050928193818,3,2,4,9,2
10232,211,7,1325.929159543754,3,1,2,6,3
10233,287,1,4352.931361039001,2,1,5,8,2
10234,180,28,4445.227102841458,3,3,5,11,1
10235,250,33,1842.5386066686508,2,4,2,8,2
10236,231,4,923.0788653529665,2,1,1,4,3
10237,23,20,4374.550576325508,5,2,5,12,1
10238,48,36,4426.635603111544,5,4,5,14,0
10239,109,31,513.5213619105582,4,4,1,9,2
10240,296,38,4835.2516181902165,1,4,5,10,1
10241,6,28,2670.071959863201,5,3,3,11,1
10242,38,3,4968.713672765251,5,1,5,11,1
10243,169,6,2230.5911685812403,3,1,3,7,2
10244,356,45,2671.0838634041447,1,5,3,9,2
10245,283,23,1337.7533315365156,2,3,2,7,2
10246,203,7,4495.747753121694,3,1,5,9,2
10247,325,36,2224.1234641921606,1,4,3,8,2
10248,313,1,4074.924127600645,1,1,5,7,2
10249,273,6,407.8740327244626,2,1,1,4,3
10250,244,24,3943.350676189115,2,3,4,9,2
10251,327,37,2456.3132798348597,1,4,3,8,2
10252,47,45,36.985319868198786,5,5,1,11,1
10253,249,36,1139.0520656039866,2,4,2,8,2
10254,79,24,976.7137551011537,4,3,1,8,2
10255,110,38,3761.3052607341046,4,4,4,12,1
10256,13,45,2391.2389270681606,5,5,3,13,0
10257,90,29,806.9947994686161,4,3,1,8,2
10258,342,37,1291.4468554558102,1,4,2,7,2
10259,348,45,2525.3432584763655,1,5,3,9,2
10260,280,32,107.9946046251726,2,4,1,7,2
10261,221,25,2126.386684615875,2,3,3,8,2
10262,73,10,3393.5264042321633,5,1,4,10,1
10263,234,35,2593.5953805765353,2,4,3,9,2
10264,260,25,2994.5167099667387,2,3,3,8,2
10265,113,27,1639.8244038881323,4,3,2,9,2
10266,46,45,923.5478628585814,5,5,1,11,1
10267,274,32,4050.6090388723533,2,4,5,11,1
10268,43,12,4529.118008467439,5,2,5,12,1
10269,208,4,2558.5954461707192,3,1,3,7,2
10270,349,42,1532.1556507811401,1,5,2,8,2
10271,103,26,2560.912099294748,4,3,3,10,1
10272,124,3,4396.137747980604,4,1,5,10,1
10273,10,17,3460.117673401836,5,2,4,11,1
10274,329,9,4294.494270587686,1,1,5,7,2
10275,187,29,1648.6133211594713,3,3,2,8,2
10276,31,1,3562.7758504041044,5,1,4,10,1
10277,156,18,3268.7143678429666,3,2,4,9,2
10278,60,41,2862.3661386455824,5,5,3,13,0
10279,249,20,2645.842077500239,2,2,3,7,2
10280,270,41,2759.379636866589,2,5,3,10,1
10281,217,34,4249.858737736228,3,4,5,12,1
10282,2,28,4580.812560010684,5,3,5,13,0
10283,24,48,573.1737172823388,5,5,1,11,1
10284,206,35,2848.1701721757686,3,4,3,10,1
10285,320,16,4592.858028141441,1,2,5,8,2
10286,199,21,682.3525259438798,3,3,1,7,2
10287,356,13,2070.168272751562,1,2,3,6,3
10288,114,35,454.51005504101073,4,4,1,9,2
10289,280,42,576.2472460285896,2,5,1,8,2
10290,155,32,4521.512954672071,3,4,5,12,1
10291,165,38,2236.4361283041617,3,4,3,10,1
10292,222,6,3446.810873482947,2,1,4,7,2
10293,91,38,703.1829719852312,4,4,1,9,2
10294,167,38,119.5179371398514,3,4,1,8,2
10295,207,13,4453.514947170831,3,2,5,10,1
10296,282,46,2876.9827413496196,2,5,3,10,1
10297,65,39,109.73890029932417,5,4,1,10,1
10298,4,13,4961.774009830656,5,2,5,12,1
10299,157,47,2466.0399912386524,3,5,3,11,1
10300,249,12,2384.6237757447266,2,2,3,7,2
10301,257,33,3108.36177976988,2,4,4,10,1
10302,235,28,49.44362563535593,2,3,1,6,3
10303,306,3,2850.000484795136,1,1,3,5,3
10304,74,18,3151.1246809083873,4,2,4,10,1
10305,187,26,1491.7983048343324,3,3,2,8,2
10306,62,40,3636.9935247438093,5,4,4,13,0
10307,337,2,1893.384762927659,1,1,2,4,3
10308,164,4,3591.6879409461194,3,1,4,8,2
10309,56,28,727.6876404780463,5,3,1,9,2
10310,111,28,4569.35210204468,4,3,5,12,1
10311,218,25,4398.492294544739,2,3,5,10,1
10312,240,26,761.6261156779752,2,3,1,6,3
10313,21,45,4692.885146056749,5,5,5,15,0
10314,141,47,2793.323561108697,4,5,3,12,1
10315,265,2,3511.2318950411923,2,1,4,7,2
10316,139,42,4203.066023958878,4,5,5,14,0
10317,70,34,427.0140359292182,5,4,1,10,1
10318,118,30,854.728943756171,4,3,1,8,2
10319,198,21,1459.0506982149493,3,3,2,8,2
10320,205,44,2391.250362121198,3,5,3,11,1
10321,214,37,1736.8119864307155,3,4,2,9,2
10322,56,44,2534.1734209408446,5,5,3,13,0
10323,287,23,937.725966445244,2,3,1,6,3
10324,293,33,3413.9491582664914,1,4,4,9,2
10325,175,2,288.1170571068185,3,1,1,5,3
10326,347,27,1813.6330359777282,1,3,2,6,3
10327,128,48,903.3758909089017,4,5,1,10,1
10328,325,22,3652.367026634695,1,3,4,8,2
10329,292,34,4419.430160761258,1,4,5,10,1
10330,288,16,403.14318392533977,2,2,1,5,3
10331,226,20,3927.338900773336,2,2,4,8,2
10332,64,26,4479.6542456732905,5,3,5,13,0
10333,48,16,4870.111380904135,5,2,5,12,1
10334,202,6,2901.137392215994,3,1,3,7,2
10335,337,45,1643.6855111769598,1,5,2,8,2
10336,60,44,1616.6482633379778,5,5,2,12,1
10337,257,23,1901.0606956793183,2,3,2,7,2
10338,65,42,3067.2103625648583,5,5,4,14,0
10339,239,37,2456.247760574234,2,4,3,9,2
10340,289,8,3271.6387817701066,2,1,4,7,2
10341,38,6,206.17622891258503,5,1,1,7,2
10342,25,37,538.3489364017573,5,4,1,10,1
10343,59,22,4882.932102139538,5,3,5,13,0
10344,357,6,4976.973655909331,1,1,5,7,2
10345,297,32,3735.8274975255554,1,4,4,9,2
10346,158,17,1289.4217794033389,3,2,2,7,2
10347,57,38,4767.374854658744,5,4,5,14,0
10348,48,17,1076.3769410206007,5,2,2,9,2
10349,328,37,3659.842298913753,1,4,4,9,2
10350,56,23,585.1389753432737,5,3,1,9,2
10351,65,49,3248.0334478135724,5,5,4,14,0
10352,268,49,3799.9798667471186,2,5,4,11,1
10353,69,13,4299.604321494532,5,2,5,12,1
10354,216,32,3674.1876370431723,3,4,4,11,1
10355,89,22,4618.191923223705,4,3,5,12,1
10356,281,7,2609.407056924618,2,1,3,6,3
10357,257,22,3390.3687483977055,2,3,4,9,2
10358,160,21,1854.0549245908762,3,3,2,8,2
10359,234,6,61.84335195366944,2,1,1,4,3
10360,131,14,3785.8978477820287,4,2,4,10,1
10361,49,16,4350.604632877316,5,2,5,12,1
10362,147,3,877.8831402785378,3,1,1,5,3
10363,316,9,152.91735080980268,1,1,1,3,3
10364,2,47,830.8642090523035,5,5,1,11,1
10365,329,21,4477.493573264052,1,3,5,9,2
10366,145,30,1484.5968429629356,4,3,2,9,2
10367,61,30,1176.1835331198217,5,3,2,10,1
10368,273,42,82.80322596764964,2,5,1,8,2
10369,49,42,1492.3051845782304,5,5,2,12,1
10370,332,32,3581.038994340959,1,4,4,9,2
10371,131,23,4795.855548997336,4,3,5,12,1
10372,43,3,1570.57874986379,5,1,2,8,2
10373,57,1,1211.0197478513592,5,1,2,8,2
10374,50,3,4441.464412108545,5,1,5,11,1
10375,178,37,4263.999205652821,3,4,5,12,1
10376,293,7,1647.520496516995,1,1,2,4,3
10377,46,3,353.3377172476994,5,1,1,7,2
10378,170,36,4960.0273079290455,3,4,5,12,1
10379,271,49,3406.714394434306,2,5,4,11,1
10380,336,3,4633.63668044983,1,1,5,7,2
10381,139,4,1715.9536268541128,4,1,2,7,2
10382,247,31,3241.950241224141,2,4,4,10,1
10383,148,2,3375.741178730998,3,1,4,8,2
10384,230,14,4365.798283019206,2,2,5,9,2
10385,280,37,4965.359605208861,2,4,5,11,1
10386,125,31,552.2442308346933,4,4,1,9,2
10387,192,2,3159.273058697853,3,1,4,8,2
10388,80,31,1688.835342329305,4,4,2,10,1
10389,94,47,4060.1755510300086,4,5,5,14,0
10390,226,43,3773.198443884747,2,5,4,11,1
10391,65,22,4463.66743587733,5,3,5,13,0
10392,88,10,1725.0773576296106,4,1,2,7,2
10393,88,30,930.8064173472475,4,3,1,8,2
10394,201,33,118.79036898430886,3,4,1,8,2
10395,214,19,1284.9783517538738,3,2,2,7,2
10396,204,46,1842.1859833786025,3,5,2,10,1
10397,89,25,4730.87425988048,4,3,5,12,1
10398,61,46,2461.949442897791,5,5,3,13,0
10399,271,1,2786.6331255028595,2,1,3,6,3
10400,94,32,4401.8425226200925,4,4,5,13,0
10401,307,25,4426.496873683062,1,3,5,9,2
10402,27,41,2644.299974550378,5,5,3,13,0
10403,214,17,577.3804586793254,3,2,1,6,3
10404,74,14,1359.8756617593358,4,2,2,8,2
10405,61,45,2289.8721180305497,5,5,3,13,0
10406,186,13,3758.335780937654,3,2,4,9,2
10407,31,38,3561.29192416227,5,4,4,13,0
10408,219,39,3217.114094145829,2,4,4,10,1
10409,12,2,4402.425343413699,5,1,5,11,1
10410,302,32,4015.2055774525556,1,4,5,10,1
10411,32,32,4910.750061630075,5,4,5,14,0
10412,160,40,4446.901019456446,3,4,5,12,1
10413,237,6,986.3255749387083,2,1,1,4,3
10414,227,25,297.50666194677416,2,3,1,6,3
10415,181,3,2078.4096107811733,3,1,3,7,2
10416,317,18,3091.3472099973824,1,2,4,7,2
10417,46,38,3219.0864634782456,5,4,4,13,0
10418,341,43,1344.8886799766099,1,5,2,8,2
10419,80,3,4300.806012598865,4,1,5,10,1
10420,135,48,1652.9398535906805,4,5,2,11,1
10421,260,5,4596.381885851886,2,1,5,8,2
10422,308,24,2363.2909925030754,1,3,3,7,2
10423,247,34,61.84942354876178,2,4,1,7,2
10424,159,47,818.5861428617835,3,5,1,9,2
10425,203,48,520.5730907084383,3,5,1,9,2
10426,112,39,229.68872104353508,4,4,1,9,2
10427,292,48,3572.946380945273,1,5,4,10,1
10428,310,24,969.656206571407,1,3,1,5,3
10429,119,36,4194.712774088366,4,4,5,13,0
10430,17,28,1329.6994557840057,5,3,2,10,1
10431,331,48,171.31226138929895,1,5,1,7,2
10432,227,49,4105.169966436393,2,5,5,12,1
10433,361,34,2336.0677941496256,1,4,3,8,2
10434,117,16,3001.5321469422793,4,2,3,9,2
10435,43,36,1687.7741703214,5,4,2,11,1
10436,115,7,239.74157681665267,4,1,1,6,3
10437,283,18,1857.1836749289819,2,2,2,6,3
10438,37,6,2596.248987764925,5,1,3,9,2
10439,302,28,68.31615164772654,1,3,1,5,3
10440,113,39,2875.707260697056,4,4,3,11,1
10441,35,34,4466.280351250272,5,4,5,14,0
10442,132,41,1097.024206875931,4,5,2,11,1
10443,336,29,4634.57811413051,1,3,5,9,2
10444,336,4,497.0665089296942,1,1,1,3,3
10445,228,14,4128.92738761188,2,2,5,9,2
10446,147,5,4203.218547927765,3,1,5,9,2
10447,122,25,1296.2217158617132,4,3,2,9,2
10448,81,39,4789.638605463252,4,4,5,13,0
10449,173,8,2088.8276413017707,3,1,3,7,2
10450,154,15,714.8678764533131,3,2,1,6,3
10451,150,19,2962.6551096275616,3,2,3,8,2
10452,58,11,4983.107373185879,5,2,5,12,1
10453,63,20,4497.464829306879,5,2,5,12,1
10454,156,36,1400.2281023143612,3,4,2,9,2
10455,356,18,2889.163130898094,1,2,3,6,3
10456,322,14,585.6846217873149,1,2,1,4,3
10457,168,38,2314.6055736420763,3,4,3,10,1
10458,166,25,2620.1196377789956,3,3,3,9,2
10459,85,16,1583.2387086723313,4,2,2,8,2
10460,137,18,2426.093543855658,4,2,3,9,2
10461,189,1,4600.492906324056,3,1,5,9,2
10462,2,40,2505.686809526856,5,4,3,12,1
10463,106,1,4156.641649732311,4,1,5,10,1
10464,364,1,1593.778241525535,1,1,2,4,3
10465,72,21,4857.307069638684,5,3,5,13,0
10466,126,25,476.38153489147555,4,3,1,8,2
10467,170,27,2932.0773677415264,3,3,3,9,2
10468,205,10,3951.540097882345,3,1,4,8,2
10469,313,12,4072.0645216881253,1,2,5,8,2
10470,337,28,999.4227428273391,1,3,1,5,3
10471,195,49,2014.2129845380812,3,5,3,11,1
10472,158,32,3124.7389005958744,3,4,4,11,1
10473,141,33,1586.254721764359,4,4,2,10,1
10474,275,8,3294.897115915265,2,1,4,7,2
10475,7,42,1900.1155498503856,5,5,2,12,1
10476,54,26,1760.8229497002594,5,3,2,10,1
10477,104,42,549.2601757371439,4,5,1,10,1
10478,342,41,205.87186547669822,1,5,1,7,2
10479,338,2,4178.016212160788,1,1,5,7,2
10480,61,35,2452.8270158588102,5,4,3,12,1
10481,87,34,2818.7369347129434,4,4,3,11,1
10482,258,6,1867.382902417118,2,1,2,5,3
10483,178,31,692.3428069141145,3,4,1,8,2
10484,242,23,2253.3642684791203,2,3,3,8,2
10485,203,12,1152.495819375532,3,2,2,7,2
10486,31,28,4190.038403418281,5,3,5,13,0
10487,289,15,4934.074804991705,2,2,5,9,2
10488,80,19,4446.58971602427,4,2,5,11,1
10489,11,12,2646.088586968896,5,2,3,10,1
10490,254,48,3144.377408458402,2,5,4,11,1
10491,287,2,4741.131488268798,2,1,5,8,2
10492,176,11,2698.0228486077385,3,2,3,8,2
10493,126,44,3196.5597252248376,4,5,4,13,0
10494,47,37,3149.855223674218,5,4,4,13,0
10495,206,38,3543.524547544201,3,4,4,11,1
10496,107,25,3205.022646895811,4,3,4,11,1
10497,275,43,3356.819936297308,2,5,4,11,1
10498,337,21,3632.2134164416634,1,3,4,8,2
10499,123,42,4047.4051560430644,4,5,5,14,0
10500,134,36,2021.2442966223905,4,4,3,11,1
10501,107,9,3731.7115814602853,4,1,4,9,2
10502,305,12,510.01675817827186,1,2,1,4,3
10503,329,10,4382.178779885227,1,1,5,7,2
10504,50,46,1457.321096466867,5,5,2,12,1
10505,337,5,2023.2669672955456,1,1,3,5,3
10506,95,33,4020.015959160967,4,4,5,13,0
10507,268,5,3188.565320074119,2,1,4,7,2
10508,23,16,1550.053669357329,5,2,2,9,2
10509,54,37,1134.741564511955,5,4,2,11,1
10510,254,37,4788.9950990658435,2,4,5,11,1
10511,235,29,448.0040415476182,2,3,1,6,3
10512,59,18,31.632191960612968,5,2,1,8,2
10513,164,29,3367.9451624088883,3,3,4,10,1
10514,259,6,3076.227391141767,2,1,4,7,2
10515,314,18,3690.6936751294015,1,2,4,7,2
10516,216,32,3660.8528197291434,3,4,4,11,1
10517,183,42,4317.663045057456,3,5,5,13,0
10518,57,47,4611.3218661382,5,5,5,15,0
10519,145,31,3877.372695406851,4,4,4,12,1
10520,90,11,1169.1410800942629,4,2,2,8,2
10521,311,26,2322.845929711881,1,3,3,7,2
10522,45,28,3212.1590508728864,5,3,4,12,1
10523,257,27,2701.4326915352626,2,3,3,8,2
10524,21,19,802.8985870487772,5,2,1,8,2
10525,21,45,2950.472422813988,5,5,3,13,0
10526,52,27,4433.777960675538,5,3,5,13,0
10527,338,20,2098.400944092837,1,2,3,6,3
10528,171,3,3347.9747939326635,3,1,4,8,2
10529,67,16,3083.5120885189276,5,2,4,11,1
10530,113,39,1891.4452529040352,4,4,2,10,1
10531,300,44,2830.703323664692,1,5,3,9,2
10532,160,29,1058.9580491553165,3,3,2,8,2
10533,266,15,2735.0752208889858,2,2,3,7,2
10534,320,30,3996.159656546992,1,3,4,8,2
10535,232,40,3797.149370260419,2,4,4,10,1
10536,325,49,1796.1932035372874,1,5,2,8,2
10537,68,1,569.3052273734788,5,1,1,7,2
10538,28,29,4001.713399548931,5,3,4,12,1
10539,116,30,1332.545056577669,4,3,2,9,2
10540,51,40,274.6883983882179,5,4,1,10,1
10541,181,46,2231.5128714778543,3,5,3,11,1
10542,260,32,3699.9579424372723,2,4,4,10,1
10543,79,10,4044.3817690410465,4,1,5,10,1
10544,273,27,4911.18872461745,2,3,5,10,1
10545,108,8,955.1443433103165,4,1,1,6,3
10546,74,36,1476.0363037980585,4,4,2,10,1
10547,175,42,3051.357587412691,3,5,4,12,1
10548,184,35,4058.605048608964,3,4,5,12,1
10549,23,36,1178.034356000037,5,4,2,11,1
10550,274,48,2055.4731073650582,2,5,3,10,1
10551,129,36,2047.9193355779357,4,4,3,11,1
10552,291,25,3866.9542981606223,2,3,4,9,2
10553,320,20,1212.2517063378177,1,2,2,5,3
10554,186,45,4844.105187932679,3,5,5,13,0
10555,59,17,2557.2144250509573,5,2,3,10,1
10556,1,23,1417.513514660517,5,3,2,10,1
10557,131,25,1428.577457995248,4,3,2,9,2
10558,67,48,101.31693365281271,5,5,1,11,1
10559,293,49,3465.230144873887,1,5,4,10,1
10560,285,31,3881.982030351233,2,4,4,10,1
10561,89,6,171.81458688921106,4,1,1,6,3
10562,100,35,2933.813350263457,4,4,3,11,1
10563,189,4,3910.5466121744053,3,1,4,8,2
10564,346,40,1887.4378414711011,1,4,2,7,2
10565,241,20,2169.3804984449016,2,2,3,7,2
10566,270,41,1814.5082505615796,2,5,2,9,2
10567,219,1,1585.0970856467052,2,1,2,5,3
10568,176,45,2460.7972010230847,3,5,3,11,1
10569,341,26,838.8422940647905,1,3,1,5,3
10570,233,34,2209.031529346976,2,4,3,9,2
10571,151,10,4709.707370118305,3,1,5,9,2
10572,277,23,146.73646800809414,2,3,1,6,3
10573,229,49,832.0696451066135,2,5,1,8,2
10574,171,24,3890.7349293256407,3,3,4,10,1
10575,223,13,668.9648786694213,2,2,1,5,3
10576,213,29,1363.6916885187,3,3,2,8,2
10577,282,46,2279.6462309813355,2,5,3,10,1
10578,41,27,4716.379665629112,5,3,5,13,0
10579,122,31,925.6709246448116,4,4,1,9,2
10580,227,43,4616.192124081539,2,5,5,12,1
10581,294,10,3595.4373184371343,1,1,4,6,3
10582,88,31,3359.0131095984284,4,4,4,12,1
10583,267,39,3620.47719500966,2,4,4,10,1
10584,29,10,165.92062865699387,5,1,1,7,2
10585,247,24,503.5123027369014,2,3,1,6,3
10586,316,33,1680.8592284137399,1,4,2,7,2
10587,244,14,379.0979904119015,2,2,1,5,3
10588,61,35,4938.072650382156,5,4,5,14,0
10589,147,45,2906.256918644436,3,5,3,11,1
10590,174,34,2441.8449190034903,3,4,3,10,1
10591,278,17,3929.7038066462287,2,2,4,8,2
10592,334,21,4885.026441991829,1,3,5,9,2
10593,142,32,4776.098700423026,4,4,5,13,0
10594,44,3,3967.3937750955934,5,1,4,10,1
10595,144,15,1892.0994424347737,4,2,2,8,2
10596,353,8,339.13786297375447,1,1,1,3,3
10597,333,32,500.901118868115,1,4,1,6,3
10598,55,38,15.75018056499153,5,4,1,10,1
10599,307,26,19.49518769203094,1,3,1,5,3
10600,358,30,4682.744776677975,1,3,5,9,2
10601,161,9,4635.814676345421,3,1,5,9,2
10602,285,32,3341.0934605269626,2,4,4,10,1
10603,325,11,3636.1168538593092,1,2,4,7,2
10604,198,22,2570.9101986836886,3,3,3,9,2
10605,159,34,1196.8328578807789,3,4,2,9,2
10606,80,41,4572.781395052957,4,5,5,14,0
10607,31,18,1395.6804221231566,5,2,2,9,2
10608,112,19,3700.9595921386763,4,2,4,10,1
10609,46,18,1234.7240667721596,5,2,2,9,2
10610,353,37,4352.040606065398,1,4,5,10,1
10611,205,18,3259.6847777831504,3,2,4,9,2
10612,52,12,3217.048152578093,5,2,4,11,1
10613,138,4,495.8625113421805,4,1,1,6,3
10614,74,47,2103.149826814316,4,5,3,12,1
10615,41,43,2629.2934526725003,5,5,3,13,0
10616,77,27,1477.2410791714392,4,3,2,9,2
10617,187,5,4406.063313048994,3,1,5,9,2
10618,52,6,4189.973008140996,5,1,5,11,1
10619,87,13,2473.168352589225,4,2,3,9,2
10620,109,23,1706.7557011941333,4,3,2,9,2
10621,225,42,4009.695937308166,2,5,4,11,1
10622,248,25,992.4883232307815,2,3,1,6,3
10623,69,46,366.8664123172275,5,5,1,11,1
10624,120,4,238.0953254990191,4,1,1,6,3
10625,67,32,203.02947188102112,5,4,1,10,1
10626,61,44,2449.5543957861905,5,5,3,13,0
10627,327,15,1284.0150441358073,1,2,2,5,3
10628,191,26,3454.9718555961176,3,3,4,10,1
10629,189,42,3272.9189544621217,3,5,4,12,1
10630,151,11,2714.6798356486843,3,2,3,8,2
10631,286,9,1770.6879743255352,2,1,2,5,3
10632,96,11,4253.776662478794,4,2,5,11,1
10633,312,2,3551.416738967267,1,1,4,6,3
10634,309,45,1364.9153589179762,1,5,2,8,2
10635,263,27,2513.4264249444145,2,3,3,8,2
10636,97,26,789.7933320330737,4,3,1,8,2
10637,113,8,1650.593692598517,4,1,2,7,2
10638,125,21,4985.729512489033,4,3,5,12,1
10639,132,21,1126.9826591333078,4,3,2,9,2
10640,121,8,3494.528755033511,4,1,4,9,2
10641,197,1,1199.7090424273713,3,1,2,6,3
10642,294,38,4691.291349638999,1,4,5,10,1
10643,122,13,1557.562896501934,4,2,2,8,2
10644,282,9,1739.9784824870794,2,1,2,5,3
10645,260,28,2973.3602676002743,2,3,3,8,2
10646,39,6,2944.6777378635243,5,1,3,9,2
10647,54,47,2899.591185087927,5,5,3,13,0
10648,161,23,2870.5407953471413,3,3,3,9,2
10649,289,48,1567.8125996638414,2,5,2,9,2
10650,200,36,2177.707014459323,3,4,3,10,1
10651,276,17,2971.2328812734754,2,2,3,7,2
10652,16,9,3359.637917098908,5,1,4,10,1
10653,173,12,1273.1137774827382,3,2,2,7,2
10654,248,22,3510.360557897675,2,3,4,9,2
10655,218,12,4617.148488062057,2,2,5,9,2
10656,87,6,3792.0592396855054,4,1,4,9,2
10657,82,44,430.3216860853814,4,5,1,10,1
10658,62,9,2350.939838249205,5,1,3,9,2
10659,287,37,2181.9665393399814,2,4,3,9,2
10660,42,3,1689.1515269711351,5,1,2,8,2
10661,12,34,2461.6874981159863,5,4,3,12,1
10662,321,8,2203.772529265395,1,1,3,5,3
10663,234,10,40.79068106512845,2,1,1,4,3
10664,329,47,1190.4108376794288,1,5,2,8,2
10665,131,41,1076.772904958913,4,5,2,11,1
10666,115,42,1752.8051108015698,4,5,2,11,1
10667,218,43,880.5391412042821,2,5,1,8,2
10668,137,9,348.3292041204448,4,1,1,6,3
10669,106,14,991.0981466247139,4,2,1,7,2
10670,179,37,4272.39206423313,3,4,5,12,1
10671,16,27,3987.2263109140004,5,3,4,12,1
10672,242,41,2216.0600251544665,2,5,3,10,1
10673,334,32,4390.29701955403,1,4,5,10,1
10674,226,4,1171.0014344227116,2,1,2,5,3
10675,242,2,2925.203614584166,2,1,3,6,3
10676,141,33,723.1951289765908,4,4,1,9,2
10677,199,21,4168.669440851455,3,3,5,11,1
10678,112,1,661.601971884344,4,1,1,6,3
10679,127,44,168.9821933024315,4,5,1,10,1
10680,21,11,1374.4867080402946,5,2,2,9,2
10681,147,1,4505.666095841647,3,1,5,9,2
10682,89,46,655.9908388129517,4,5,1,10,1
10683,303,11,1660.0446407907427,1,2,2,5,3
10684,203,7,1588.9108151308415,3,1,2,6,3
10685,85,2,4010.2149077434865,4,1,4,9,2
10686,167,15,2113.4117449023224,3,2,3,8,2
10687,72,8,3061.71957757727,5,1,4,10,1
10688,298,47,2027.8711991060486,1,5,3,9,2
10689,9,26,2761.770505532976,5,3,3,11,1
10690,281,40,321.5792128469843,2,4,1,7,2
10691,258,42,1876.406896319273,2,5,2,9,2
10692,275,35,4276.978130322369,2,4,5,11,1
10693,238,46,3458.427140279386,2,5,4,11,1
10694,20,41,4909.326930291633,5,5,5,15,0
10695,233,41,3941.7184915069543,2,5,4,11,1
10696,221,21,2263.0334773099526,2,3,3,8,2
10697,326,38,3384.6394839207187,1,4,4,9,2
10698,17,8,3881.8092416845625,5,1,4,10,1
10699,89,43,1355.7214630074923,4,5,2,11,1
10700,196,32,309.4892741717655,3,4,1,8,2
10701,350,8,2035.177867312756,1,1,3,5,3
10702,84,44,731.9190788915511,4,5,1,10,1
10703,87,10,1393.4331876148844,4,1,2,7,2
10704,307,23,4734.759022415925,1,3,5,9,2
10705,338,4,4236.9421401803675,1,1,5,7,2
10706,154,48,2966.3945344926246,3,5,3,11,1
10707,228,38,2012.270965596538,2,4,3,9,2
10708,264,30,1329.008497437179,2,3,2,7,2
10709,223,41,2861.576815796147,2,5,3,10,1
10710,121,23,2670.469645867734,4,3,3,10,1
10711,173,5,3906.0962338238496,3,1,4,8,2
10712,4,21,4640.820741932645,5,3,5,13,0
10713,342,6,1651.3971336367947,1,1,2,4,3
10714,128,49,1039.4225826764027,4,5,2,11,1
10715,110,17,2019.9700835690685,4,2,3,9,2
10716,355,25,2193.3310990418886,1,3,3,7,2
10717,37,24,208.9527445269686,5,3,1,9,2
10718,71,22,4309.865695675619,5,3,5,13,0
10719,289,13,4978.005769950802,2,2,5,9,2
10720,31,17,4616.811376630497,5,2,5,12,1
10721,268,14,4304.718247639683,2,2,5,9,2
10722,11,34,4963.07551426311,5,4,5,14,0
10723,344,26,4539.9640755546825,1,3,5,9,2
10724,328,19,3444.954427509153,1,2,4,7,2
10725,32,26,842.1156773731167,5,3,1,9,2
10726,57,3,790.1871154509704,5,1,1,7,2
10727,166,2,253.41093535113004,3,1,1,5,3
10728,188,28,2065.036027266206,3,3,3,9,2
10729,342,2,4046.032144679118,1,1,5,7,2
10730,19,22,2456.5767645465635,5,3,3,11,1
10731,116,7,1837.9453115007962,4,1,2,7,2
10732,184,4,555.0869623517613,3,1,1,5,3
10733,270,49,268.249012362035,2,5,1,8,2
10734,33,38,2001.9039256838003,5,4,2,11,1
10735,10,39,508.6276471168248,5,4,1,10,1
10736,80,20,526.705381962534,4,2,1,7,2
10737,192,6,1982.7886406035248,3,1,2,6,3
10738,320,9,2519.1888479485533,1,1,3,5,3
10739,190,31,941.5476060028302,3,4,1,8,2
10740,68,26,3426.33207443958,5,3,4,12,1
10741,348,36,2099.2730834072263,1,4,3,8,2
10742,125,26,468.6934633161931,4,3,1,8,2
10743,336,28,3188.8002815679492,1,3,4,8,2
10744,59,5,1791.1546452887428,5,1,2,8,2
10745,97,10,271.08417061056844,4,1,1,6,3
10746,275,18,4740.428082539289,2,2,5,9,2
10747,149,15,2860.2728159572916,3,2,3,8,2
10748,278,33,2393.82464146288,2,4,3,9,2
10749,265,5,4297.095600320635,2,1,5,8,2
10750,9,37,4684.334742275487,5,4,5,14,0
10751,283,40,1109.4061221493946,2,4,2,8,2
10752,273,22,4052.6210633583855,2,3,5,10,1
10753,301,22,4157.088834603583,1,3,5,9,2
10754,8,22,281.46994544121907,5,3,1,9,2
10755,208,15,3562.601134739581,3,2,4,9,2
10756,125,17,324.20973017988933,4,2,1,7,2
10757,123,45,2977.419499485605,4,5,3,12,1
10758,33,28,3349.4915179219834,5,3,4,12,1
10759,1,22,1841.622854871339,5,3,2,10,1
10760,204,21,4405.129608321713,3,3,5,11,1
10761,6,42,4004.553417767687,5,5,4,14,0
10762,297,17,4630.538970970768,1,2,5,8,2
10763,5,5,1581.2987378885991,5,1,2,8,2
10764,80,18,117.42372230843627,4,2,1,7,2
10765,274,17,4059.1917223177848,2,2,5,9,2
10766,177,4,1122.6570064222394,3,1,2,6,3
10767,338,7,2341.1086424296077,1,1,3,5,3
10768,321,25,4088.4326476015135,1,3,5,9,2
10769,339,37,1088.514541589701,1,4,2,7,2
10770,136,40,1566.4247263037555,4,4,2,10,1
10771,25,40,2201.0091318255677,5,4,3,12,1
10772,325,43,1366.4060023255506,1,5,2,8,2
10773,183,9,2311.993900784115,3,1,3,7,2
10774,168,19,57.88725602768816,3,2,1,6,3
10775,338,9,1068.8179840291232,1,1,2,4,3
10776,178,23,4164.441264718248,3,3,5,11,1
10777,95,31,2073.274972979874,4,4,3,11,1
10778,33,32,3185.664781032279,5,4,4,13,0
10779,111,31,1169.1167589013567,4,4,2,10,1
10780,146,17,3252.8945355988435,4,2,4,10,1
10781,231,48,4999.869599554821,2,5,5,12,1
10782,272,39,2980.4853205900567,2,4,3,9,2
10783,336,22,3145.509227583125,1,3,4,8,2
10784,38,35,566.4839240653674,5,4,1,10,1
10785,135,30,2022.873543613263,4,3,3,10,1
10786,334,40,4305.017243429619,1,4,5,10,1
10787,235,37,4173.017148555078,2,4,5,11,1
10788,319,26,2616.7715607029963,1,3,3,7,2
10789,345,6,4518.236207191485,1,1,5,7,2
10790,160,34,723.255720846533,3,4,1,8,2
10791,38,32,3294.3651292610107,5,4,4,13,0
10792,150,25,1251.929046745955,3,3,2,8,2
10793,308,13,3231.3514114751306,1,2,4,7,2
10794,29,38,446.12444863492703,5,4,1,10,1
10795,144,38,4718.609384573644,4,4,5,13,0
10796,76,2,3933.7968775565587,4,1,4,9,2
10797,145,5,1012.798208830495,4,1,1,6,3
10798,229,11,3190.010077174466,2,2,4,8,2
10799,64,11,3798.136746281981,5,2,4,11,1
10800,347,24,1055.1346509285108,1,3,2,6,3
10801,345,14,475.71823549274575,1,2,1,4,3
10802,269,45,1765.381032817542,2,5,2,9,2
10803,328,30,687.4141625642077,1,3,1,5,3
10804,184,40,2832.9014084701043,3,4,3,10,1
10805,261,47,2126.333398771341,2,5,3,10,1
10806,268,44,2317.497447123518,2,5,3,10,1
10807,169,35,2718.888751932625,3,4,3,10,1
10808,259,21,4910.440208253582,2,3,5,10,1
10809,227,5,3965.2519753415336,2,1,4,7,2
10810,33,38,3151.062759964425,5,4,4,13,0
10811,214,2,1824.8910162518873,3,1,2,6,3
10812,50,40,145.07607215345598,5,4,1,10,1
10813,210,37,591.4727774865711,3,4,1,8,2
10814,29,49,3657.027580191525,5,5,4,14,0
10815,39,34,1852.327601927195,5,4,2,11,1
10816,347,11,1678.8428048547978,1,2,2,5,3
10817,100,36,4446.002009368337,4,4,5,13,0
10818,173,11,2427.699363663718,3,2,3,8,2
10819,17,9,4498.889516491417,5,1,5,11,1
10820,56,6,4434.326166906976,5,1,5,11,1
10821,226,34,410.10464565562677,2,4,1,7,2
10822,46,47,4727.361262383343,5,5,5,15,0
10823,67,37,394.00486920171153,5,4,1,10,1
10824,197,32,4817.895515083592,3,4,5,12,1
10825,142,12,2268.548438820958,4,2,3,9,2
10826,323,45,3806.6947720153357,1,5,4,10,1
10827,23,32,3533.6603922773684,5,4,4,13,0
10828,94,17,2597.2899218793973,4,2,3,9,2
10829,242,4,3101.07954598986,2,1,4,7,2
10830,237,42,4750.091725680982,2,5,5,12,1
10831,54,33,4637.483938409569,5,4,5,14,0
10832,138,43,3275.0869907928436,4,5,4,13,0
10833,333,48,3292.0162078832805,1,5,4,10,1
10834,272,43,1242.2240800252719,2,5,2,9,2
10835,41,9,4144.831238643438,5,1,5,11,1
10836,98,34,3166.6906316803634,4,4,4,12,1
10837,183,39,4132.981472072168,3,4,5,12,1
10838,128,30,3292.683527337003,4,3,4,11,1
10839,229,20,1503.6069298977588,2,2,2,6,3
10840,317,39,955.5121996267582,1,4,1,6,3
10841,86,23,394.05956267354566,4,3,1,8,2
10842,256,41,2934.114711978033,2,5,3,10,1
10843,209,44,1427.4162739685876,3,5,2,10,1
10844,215,35,3156.242477808163,3,4,4,11,1
10845,100,23,302.69565997001996,4,3,1,8,2
10846,49,48,1884.558694378079,5,5,2,12,1
10847,201,39,1310.1605446951803,3,4,2,9,2
10848,258,23,1857.967049225554,2,3,2,7,2
10849,178,37,280.87431448536944,3,4,1,8,2
10850,245,23,3623.6652799788985,2,3,4,9,2
10851,123,39,592.3196923834365,4,4,1,9,2
10852,342,28,81.86910547728476,1,3,1,5,3
10853,171,19,4731.982615932774,3,2,5,10,1
10854,333,49,972.453148001599,1,5,1,7,2
10855,136,48,4142.025879242849,4,5,5,14,0
10856,59,30,4822.70829278805,5,3,5,13,0
10857,193,21,2675.264785848122,3,3,3,9,2
10858,268,24,2635.3296186372568,2,3,3,8,2
10859,260,21,1843.4120524672142,2,3,2,7,2
10860,95,26,2133.7183752292203,4,3,3,10,1
10861,125,36,2415.5562307971672,4,4,3,11,1
10862,41,26,768.9510745659397,5,3,1,9,2
10863,254,33,1830.0362524623922,2,4,2,8,2
10864,7,36,4082.3811286211317,5,4,5,14,0
10865,216,4,920.1666167115475,3,1,1,5,3
10866,69,9,3651.9677023010354,5,1,4,10,1
10867,69,8,3261.4171353382717,5,1,4,10,1
10868,81,2,295.915898660469,4,1,1,6,3
10869,30,29,121.92005350402539,5,3,1,9,2
10870,73,23,1769.1170282659616,5,3,2,10,1
10871,262,6,3463.929682887887,2,1,4,7,2
10872,89,43,1658.7854575297013,4,5,2,11,1
10873,208,36,3341.989169996464,3,4,4,11,1
10874,213,46,3330.636133709628,3,5,4,12,1
10875,322,21,4034.7075668951006,1,3,5,9,2
10876,266,22,506.43321737218537,2,3,1,6,3
10877,293,9,2889.8731670254438,1,1,3,5,3
10878,207,34,321.86062667083934,3,4,1,8,2
10879,333,26,887.9762299639556,1,3,1,5,3
10880,77,1,1634.2495052521513,4,1,2,7,2
10881,288,36,3539.872309743035,2,4,4,10,1
10882,47,44,4869.651095270367,5,5,5,15,0
10883,110,5,1719.1788637856941,4,1,2,7,2
10884,200,41,2610.510982159394,3,5,3,11,1
10885,210,22,1302.6874211579527,3,3,2,8,2
10886,154,4,3380.6932068419774,3,1,4,8,2
10887,10,48,1839.2634810727277,5,5,2,12,1
10888,353,2,2413.164905457005,1,1,3,5,3
10889,157,16,2843.386250494638,3,2,3,8,2
10890,261,16,3434.34922623731,2,2,4,8,2
10891,77,22,309.65778983586875,4,3,1,8,2
10892,257,43,2778.9564579951025,2,5,3,10,1
10893,131,1,2161.508848094036,4,1,3,8,2
10894,67,15,677.487781533539,5,2,1,8,2
10895,228,24,1048.1029749734948,2,3,2,7,2
10896,163,4,4420.611554589686,3,1,5,9,2
10897,15,18,4360.1622854101815,5,2,5,12,1
10898,232,17,176.31796957413763,2,2,1,5,3
10899,195,7,3450.113441268899,3,1,4,8,2
10900,349,45,2775.3946925553973,1,5,3,9,2
10901,30,10,4699.681057304771,5,1,5,11,1
10902,359,1,4540.948498001855,1,1,5,7,2
10903,338,2,2902.0139451332866,1,1,3,5,3
10904,331,49,703.385057379333,1,5,1,7,2
10905,316,22,2304.476968109808,1,3,3,7,2
10906,296,32,3628.5701909757386,1,4,4,9,2
10907,330,29,4759.165809098458,1,3,5,9,2
10908,220,35,1825.5087347053873,2,4,2,8,2
10909,147,17,3925.510665008224,3,2,4,9,2
10910,259,12,3419.8703588758012,2,2,4,8,2
10911,292,24,400.680957939888,1,3,1,5,3
10912,299,30,2794.304482928577,1,3,3,7,2
10913,143,44,925.7090793615354,4,5,1,10,1
10914,235,30,3420.910967967045,2,3,4,9,2
10915,115,20,3054.3233862337897,4,2,4,10,1
10916,90,42,4865.509977252827,4,5,5,14,0
10917,208,7,4677.5594989728,3,1,5,9,2
10918,164,42,56.770439658417146,3,5,1,9,2
10919,84,38,409.34685655678106,4,4,1,9,2
10920,77,7,3847.9802140335105,4,1,4,9,2
10921,161,49,3431.3589341506236,3,5,4,12,1
10922,5,30,4006.718536599288,5,3,4,12,1
10923,78,12,1341.4064641149348,4,2,2,8,2
10924,91,49,4248.120616124758,4,5,5,14,0
10925,87,31,2217.673165220798,4,4,3,11,1
10926,270,18,1316.9233385254643,2,2,2,6,3
10927,104,46,62.932660448612864,4,5,1,10,1
10928,339,43,4358.106533749773,1,5,5,11,1
10929,175,2,2681.3658077084606,3,1,3,7,2
10930,54,33,4877.156597922443,5,4,5,14,0
10931,211,11,3576.2601339406247,3,2,4,9,2
10932,95,34,411.28154601399507,4,4,1,9,2
10933,223,16,2945.0740201466906,2,2,3,7,2
10934,9,35,95.451453718504,5,4,1,10,1
10935,53,33,2793.3314525225314,5,4,3,12,1
10936,77,21,1757.5062988644129,4,3,2,9,2
10937,206,20,3220.0462152466403,3,2,4,9,2
10938,316,8,2712.455289168891,1,1,3,5,3
10939,302,26,1314.138113838297,1,3,2,6,3
10940,310,33,820.1295394380618,1,4,1,6,3
10941,330,26,2029.5103168453304,1,3,3,7,2
10942,112,37,4934.313211099527,4,4,5,13,0
10943,351,30,2184.1362163408658,1,3,3,7,2
10944,165,31,3746.447817733235,3,4,4,11,1
10945,279,33,294.29789277079993,2,4,1,7,2
10946,27,11,1900.540164442844,5,2,2,9,2
10947,70,41,2905.811955623029,5,5,3,13,0
10948,218,5,3758.470601509126,2,1,4,7,2
10949,189,2,2646.6344500121295,3,1,3,7,2
10950,333,13,2581.3247735458986,1,2,3,6,3
10951,306,18,3821.8954938598736,1,2,4,7,2
10952,124,26,1573.3057094213123,4,3,2,9,2
10953,19,25,462.1464991482488,5,3,1,9,2
10954,257,44,1742.2808503768545,2,5,2,9,2
10955,296,14,803.3912148926788,1,2,1,4,3
10956,22,5,4830.061578625832,5,1,5,11,1
10957,40,42,2891.7826219086915,5,5,3,13,0
10958,38,2,2238.536152324817,5,1,3,9,2
10959,48,4,4561.138872001271,5,1,5,11,1
10960,183,12,4502.803322961845,3,2,5,10,1
10961,75,11,2084.329422580306,4,2,3,9,2
10962,209,4,4374.889537626554,3,1,5,9,2
10963,183,43,329.4894063836314,3,5,1,9,2
10964,107,9,4429.738535209409,4,1,5,10,1
10965,188,10,1559.8118074916042,3,1,2,6,3
10966,264,27,2829.9601988597,2,3,3,8,2
10967,86,6,1355.746030529231,4,1,2,7,2
10968,324,15,4924.149790275003,1,2,5,8,2
10969,331,42,368.1821168480383,1,5,1,7,2
10970,137,31,2240.306881035449,4,4,3,11,1
10971,346,22,3108.730892619471,1,3,4,8,2
10972,336,6,3081.905139163079,1,1,4,6,3
10973,95,33,3696.404364926571,4,4,4,12,1
10974,326,29,3624.832478346995,1,3,4,8,2
10975,245,21,3967.7820989495144,2,3,4,9,2
10976,90,30,1179.0941733535612,4,3,2,9,2
10977,59,21,1858.8274020754538,5,3,2,10,1
10978,28,36,1916.3452487415607,5,4,2,11,1
10979,72,22,4779.639907941609,5,3,5,13,0
10980,270,46,2052.466166855189,2,5,3,10,1
10981,24,20,1117.1273614163379,5,2,2,9,2
10982,112,22,3165.398687694836,4,3,4,11,1
10983,300,40,2142.0619049778893,1,4,3,8,2
10984,56,11,1257.8995149475838,5,2,2,9,2
10985,223,47,3578.5260175464236,2,5,4,11,1
10986,120,31,967.707180372165,4,4,1,9,2
10987,179,40,3170.4366628901485,3,4,4,11,1
10988,288,13,2158.348241588015,2,2,3,7,2
10989,281,18,1602.644150010054,2,2,2,6,3
10990,189,22,4730.451514761633,3,3,5,11,1
10991,66,17,1628.7934639957516,5,2,2,9,2
10992,298,38,1744.0617970083415,1,4,2,7,2
10993,249,25,4354.485437024523,2,3,5,10,1
10994,76,32,653.9263807487112,4,4,1,9,2
10995,137,15,549.2630607338447,4,2,1,7,2
10996,164,13,1420.7118425816673,3,2,2,7,2
10997,233,26,2962.2632571395543,2,3,3,8,2
10998,255,11,1927.6577989495886,2,2,2,6,3
10999,294,13,3046.6868593700187,1,2,4,7,2
11000,170,33,807.1556489117289,3,4,1,8,2
11001,317,37,1314.6397353490618,1,4,2,7,2
11002,174,38,2830.1600457242334,3,4,3,10,1
11003,345,1,1093.5745192710745,1,1,2,4,3
11004,18,39,2119.79510614732,5,4,3,12,1
11005,70,27,2867.5129061885314,5,3,3,11,1
11006,338,36,4868.518002381763,1,4,5,10,1
11007,116,32,408.63442280919,4,4,1,9,2
11008,80,41,2307.4657530688155,4,5,3,12,1
11009,15,15,1987.392094103233,5,2,2,9,2
11010,176,31,4122.963834761378,3,4,5,12,1
11011,269,6,4502.482623951887,2,1,5,8,2
11012,119,25,4535.995710971511,4,3,5,12,1
11013,299,49,1881.9451720775528,1,5,2,8,2
11014,188,18,1530.2291830084553,3,2,2,7,2
11015,57,22,2251.1948797708724,5,3,3,11,1
11016,199,31,1726.491666799297,3,4,2,9,2
11017,17,36,3597.0663930352857,5,4,4,13,0
11018,288,9,1075.7195326616168,2,1,2,5,3
11019,55,46,3296.8335795286675,5,5,4,14,0
11020,269,3,4635.667790191459,2,1,5,8,2
11021,303,33,1406.7687127835884,1,4,2,7,2
11022,87,27,3387.6841767782335,4,3,4,11,1
11023,318,43,726.3699965713179,1,5,1,7,2
11024,29,1,615.705871065323,5,1,1,7,2
11025,22,44,587.0659455436813,5,5,1,11,1
11026,321,9,701.255567528291,1,1,1,3,3
11027,285,5,1088.6627028441155,2,1,2,5,3
11028,48,15,2818.5241730529538,5,2,3,10,1
11029,5,9,3837.2583865915317,5,1,4,10,1
11030,250,45,643.0165483174698,2,5,1,8,2
11031,163,28,4351.3745535477165,3,3,5,11,1
11032,202,13,4215.154259306827,3,2,5,10,1
11033,101,24,3639.6662522494285,4,3,4,11,1
11034,71,45,2135.5693393127503,5,5,3,13,0
11035,163,10,17.770601779373905,3,1,1,5,3
11036,173,42,3676.477057088481,3,5,4,12,1
11037,141,22,4396.140861935432,4,3,5,12,1
11038,138,39,1683.0790170975913,4,4,2,10,1
11039,66,22,3592.7579304933824,5,3,4,12,1
11040,198,37,319.6175956627957,3,4,1,8,2
11041,328,39,3550.379408643497,1,4,4,9,2
11042,228,20,350.85951903597635,2,2,1,5,3
11043,281,10,2940.0598160845234,2,1,3,6,3
11044,172,10,2991.7908966175155,3,1,3,7,2
11045,316,26,1517.7612065748592,1,3,2,6,3
11046,40,25,404.82240811289023,5,3,1,9,2
11047,7,28,4747.180525815062,5,3,5,13,0
11048,174,13,2682.5312460428995,3,2,3,8,2
11049,151,15,2902.993044368074,3,2,3,8,2
11050,211,6,3078.9542362620637,3,1,4,8,2
11051,302,12,4456.329155361514,1,2,5,8,2
11052,86,19,310.6756662883203,4,2,1,7,2
11053,253,32,4467.505961584139,2,4,5,11,1
11054,21,11,1205.9857779702577,5,2,2,9,2
11055,257,38,398.97174548577374,2,4,1,7,2
11056,33,33,3289.7566021353437,5,4,4,13,0
11057,260,2,4885.108464840851,2,1,5,8,2
11058,234,15,295.6379108699135,2,2,1,5,3
11059,3,36,2136.347872006456,5,4,3,12,1
11060,347,5,2653.6247814654907,1,1,3,5,3
11061,308,15,1268.0736308764156,1,2,2,5,3
11062,227,43,4914.5320242733105,2,5,5,12,1
11063,284,10,3208.4064408730987,2,1,4,7,2
11064,70,17,4223.30985750509,5,2,5,12,1
11065,313,34,2084.730633038851,1,4,3,8,2
11066,364,24,1776.2398768526405,1,3,2,6,3
11067,254,10,2770.25789545665,2,1,3,6,3
11068,144,30,2182.039428706932,4,3,3,10,1
11069,24,3,3577.5907951326044,5,1,4,10,1
11070,234,37,1336.4322701568556,2,4,2,8,2
11071,333,3,2253.459245151074,1,1,3,5,3
11072,175,40,4476.712408997359,3,4,5,12,1
11073,332,5,3782.9784227132136,1,1,4,6,3
11074,325,28,848.6701234392931,1,3,1,5,3
11075,357,44,4435.4554986640715,1,5,5,11,1
11076,159,14,2949.1927863214883,3,2,3,8,2
11077,348,39,3399.643044529691,1,4,4,9,2
11078,348,11,1478.3402635878376,1,2,2,5,3
11079,286,8,2213.3058755419306,2,1,3,6,3
11080,18,37,4035.9942697421925,5,4,5,14,0
11081,44,8,1660.0743316282787,5,1,2,8,2
11082,155,12,833.6574613958644,3,2,1,6,3
11083,355,15,1897.741515787568,1,2,2,5,3
11084,231,19,355.4011503728466,2,2,1,5,3
11085,316,48,3592.103727839812,1,5,4,10,1
11086,225,46,747.252084783247,2,5,1,8,2
11087,217,28,1432.7782762336153,3,3,2,8,2
11088,56,7,4406.594217713921,5,1,5,11,1
11089,31,40,2707.0833132042876,5,4,3,12,1
11090,357,7,1613.4788185764135,1,1,2,4,3
11091,59,30,2742.85778117428,5,3,3,11,1
11092,353,18,1099.205521563128,1,2,2,5,3
11093,235,24,135.61391723099462,2,3,1,6,3
11094,107,6,3022.625070029377,4,1,3,8,2
11095,191,4,3573.488404595799,3,1,4,8,2
11096,18,3,4400.1110095754375,5,1,5,11,1
11097,226,49,3861.697971712971,2,5,4,11,1
11098,167,47,4634.12172547262,3,5,5,13,0
11099,71,6,4929.907842958923,5,1,5,11,1
11100,362,26,3727.227884251533,1,3,4,8,2
11101,54,44,4340.937271143367,5,5,5,15,0
11102,245,38,3371.920201108642,2,4,4,10,1
11103,350,11,862.9795781292629,1,2,1,4,3
11104,76,29,916.6951073482019,4,3,1,8,2
11105,35,20,560.194687013163,5,2,1,8,2
11106,267,10,4715.443852767683,2,1,5,8,2
11107,317,26,3367.030972218507,1,3,4,8,2
11108,300,48,3951.6496548229675,1,5,4,10,1
11109,121,27,1662.4751107535774,4,3,2,9,2
11110,324,14,2307.5043332830214,1,2,3,6,3
11111,25,36,208.4998638650971,5,4,1,10,1
11112,160,12,4446.146928171136,3,2,5,10,1
11113,84,23,4266.487112763924,4,3,5,12,1
11114,114,21,3926.2085609728283,4,3,4,11,1
11115,223,8,300.9273177291456,2,1,1,4,3
11116,166,39,879.5061805313943,3,4,1,8,2
11117,191,9,1677.5115821947625,3,1,2,6,3
11118,175,24,1322.6827499549418,3,3,2,8,2
11119,1,31,4193.9145942700325,5,4,5,14,0
11120,229,25,982.2304334210935,2,3,1,6,3
11121,86,17,2665.301082041483,4,2,3,9,2
11122,62,42,2861.191678118368,5,5,3,13,0
11123,320,29,2130.8091173410608,1,3,3,7,2
11124,206,3,1211.0327793349916,3,1,2,6,3
11125,105,21,4801.868511496846,4,3,5,12,1
11126,318,8,2072.862218922422,1,1,3,5,3
11127,291,14,3639.2768777279575,2,2,4,8,2
11128,250,39,928.3919734045821,2,4,1,7,2
11129,13,16,4115.827730995779,5,2,5,12,1
11130,163,18,1087.300197935997,3,2,2,7,2
11131,43,31,3379.7800516294005,5,4,4,13,0
11132,111,11,2537.415047347884,4,2,3,9,2
11133,205,38,741.3201334973181,3,4,1,8,2
11134,256,20,134.49648881882558,2,2,1,5,3
11135,307,46,4654.433844255211,1,5,5,11,1
11136,144,45,637.1956626870539,4,5,1,10,1
11137,146,4,3527.707629147705,4,1,4,9,2
11138,301,20,3266.8979451454506,1,2,4,7,2
11139,164,31,1715.1830118181472,3,4,2,9,2
11140,169,20,935.0606687780954,3,2,1,6,3
11141,298,11,899.85796478252,1,2,1,4,3
11142,233,1,2930.785986720693,2,1,3,6,3
11143,271,44,2739.1372601739868,2,5,3,10,1
11144,60,18,4380.915751547658,5,2,5,12,1
11145,296,39,3203.615361275562,1,4,4,9,2
11146,235,44,4098.182130641819,2,5,5,12,1
11147,165,33,171.7411816385178,3,4,1,8,2
11148,194,36,3358.2558036726896,3,4,4,11,1
11149,234,18,1176.2061057638086,2,2,2,6,3
11150,183,47,1271.6664102288937,3,5,2,10,1
11151,333,31,3605.6768801558114,1,4,4,9,2
11152,232,35,3969.230464536455,2,4,4,10,1
11153,361,39,1864.9600209413777,1,4,2,7,2
11154,107,38,3952.483316172848,4,4,4,12,1
11155,223,15,2224.2859300082546,2,2,3,7,2
11156,80,47,4289.6502883682,4,5,5,14,0
11157,234,6,134.26982317117722,2,1,1,4,3
11158,184,8,426.6404033661047,3,1,1,5,3
11159,185,40,3883.9955182657313,3,4,4,11,1
11160,134,22,3124.207242873358,4,3,4,11,1
11161,220,1,2799.5110656412367,2,1,3,6,3
11162,288,13,3073.754248619481,2,2,4,8,2
11163,364,24,4651.651230836532,1,3,5,9,2
11164,202,21,3281.1297868759502,3,3,4,10,1
11165,146,45,3240.9058221325813,4,5,4,13,0
11166,324,43,3799.7596897340763,1,5,4,10,1
11167,127,4,4334.4373211427355,4,1,5,10,1
11168,135,7,1316.9432664093913,4,1,2,7,2
11169,114,12,3087.576807574187,4,2,4,10,1
11170,264,13,2924.0350681268515,2,2,3,7,2
11171,64,44,682.8989126767292,5,5,1,11,1
11172,135,16,2606.3816998144525,4,2,3,9,2
11173,41,6,357.0570685549222,5,1,1,7,2
11174,296,14,932.9483411376748,1,2,1,4,3
11175,3,48,4565.68577877172,5,5,5,15,0
11176,194,31,605.0234758962939,3,4,1,8,2
11177,110,36,2898.7923362355045,4,4,3,11,1
11178,221,37,1624.1686730054373,2,4,2,8,2
11179,4,41,2781.0133207257963,5,5,3,13,0
11180,244,35,1182.5179768374915,2,4,2,8,2
11181,166,10,2227.453478841524,3,1,3,7,2
11182,26,17,4337.993831409821,5,2,5,12,1
11183,17,42,1887.3227193185883,5,5,2,12,1
11184,216,30,1771.624380624669,3,3,2,8,2
11185,92,44,2236.12921555563,4,5,3,12,1
11186,31,7,511.45929277913314,5,1,1,7,2
11187,205,18,1942.861652694394,3,2,2,7,2
11188,207,19,44.4322506345462,3,2,1,6,3
11189,107,15,2521.95175429327,4,2,3,9,2
11190,146,39,4241.225984965632,4,4,5,13,0
11191,101,44,2764.8447886986833,4,5,3,12,1
11192,318,22,3042.548639248037,1,3,4,8,2
11193,241,39,162.51122258623425,2,4,1,7,2
11194,247,42,4298.9797507792155,2,5,5,12,1
11195,163,30,1931.1677284732903,3,3,2,8,2
11196,173,20,4874.514876227467,3,2,5,10,1
11197,35,32,611.1221939559973,5,4,1,10,1
11198,284,42,4723.912705078336,2,5,5,12,1
11199,359,25,3175.1116226182517,1,3,4,8,2
11200,358,23,271.1780984500646,1,3,1,5,3
11201,21,5,4858.778398405289,5,1,5,11,1
11202,308,41,79.22661004486797,1,5,1,7,2
11203,163,30,3656.1938417680462,3,3,4,10,1
11204,97,48,4448.754442456592,4,5,5,14,0
11205,307,39,887.2996556084853,1,4,1,6,3
11206,339,27,1723.3523815820643,1,3,2,6,3
11207,55,42,2810.5344092889122,5,5,3,13,0
11208,333,37,3402.2483363663655,1,4,4,9,2
11209,127,7,4360.660580295025,4,1,5,10,1
11210,193,5,3807.7416496827464,3,1,4,8,2
11211,243,15,1823.0224076564991,2,2,2,6,3
11212,349,42,4110.381860815475,1,5,5,11,1
11213,88,8,4830.7228382241965,4,1,5,10,1
11214,336,9,1142.6610443957638,1,1,2,4,3
11215,215,11,379.7370113376027,3,2,1,6,3
11216,92,22,2138.8324623900608,4,3,3,10,1
11217,303,34,4408.171548748179,1,4,5,10,1
11218,235,35,759.9546093471818,2,4,1,7,2
11219,184,13,4430.13295753123,3,2,5,10,1
11220,38,11,4961.142988443471,5,2,5,12,1
11221,139,32,279.4711321069503,4,4,1,9,2
11222,195,42,2481.329305538865,3,5,3,11,1
11223,15,15,1651.1386186191187,5,2,2,9,2
11224,257,38,1974.4624761072416,2,4,2,8,2
11225,135,1,2263.65741420808,4,1,3,8,2
11226,1,46,3701.122742691437,5,5,4,14,0
11227,49,24,2960.58551882417,5,3,3,11,1
11228,96,43,4806.393430201733,4,5,5,14,0
11229,201,40,1670.495350205275,3,4,2,9,2
11230,26,22,2712.105371588886,5,3,3,11,1
11231,343,3,4068.5093693591484,1,1,5,7,2
11232,235,14,1871.4118007984641,2,2,2,6,3
11233,349,2,2331.8430110484387,1,1,3,5,3
11234,244,32,3428.0230178992815,2,4,4,10,1
11235,358,48,4305.113650835488,1,5,5,11,1
11236,327,38,2084.2505374149055,1,4,3,8,2
11237,351,33,2664.432856012233,1,4,3,8,2
11238,51,46,4875.860203601286,5,5,5,15,0
11239,81,42,221.92111811555,4,5,1,10,1
11240,36,6,2246.6612961311275,5,1,3,9,2
11241,67,41,3183.5494371347104,5,5,4,14,0
11242,129,39,52.05301323500451,4,4,1,9,2
11243,155,25,2987.9646428164087,3,3,3,9,2
11244,245,34,290.4377737684148,2,4,1,7,2
11245,111,11,4289.2163992744345,4,2,5,11,1
11246,168,46,4037.359616587744,3,5,5,13,0
11247,142,37,170.95313262499536,4,4,1,9,2
11248,356,41,253.5320825413067,1,5,1,7,2
11249,197,7,3770.533518492396,3,1,4,8,2
11250,109,46,1854.0290139657686,4,5,2,11,1
11251,79,48,2879.3786818122408,4,5,3,12,1
11252,161,22,1358.9380661292657,3,3,2,8,2
11253,19,48,873.1146917594576,5,5,1,11,1
11254,127,39,1487.424816562332,4,4,2,10,1
11255,205,10,1241.1013641177005,3,1,2,6,3
11256,29,21,2247.0541168142786,5,3,3,11,1
11257,207,6,3735.9140647855543,3,1,4,8,2
11258,280,49,2775.1057455555137,2,5,3,10,1
11259,151,1,3049.7997566191953,3,1,4,8,2
11260,240,34,2355.6921963258405,2,4,3,9,2
11261,266,14,1630.420864612053,2,2,2,6,3
11262,182,36,726.1090385488347,3,4,1,8,2
11263,105,27,1779.2816409788647,4,3,2,9,2
11264,236,9,3329.3410949071867,2,1,4,7,2
11265,173,6,3671.549340389864,3,1,4,8,2
11266,158,31,2351.2159041019854,3,4,3,10,1
11267,172,17,3228.536400169398,3,2,4,9,2
11268,311,43,1060.5999986024187,1,5,2,8,2
11269,157,36,4301.730940412543,3,4,5,12,1
11270,258,21,4331.022888875359,2,3,5,10,1
11271,164,27,1608.4363570899015,3,3,2,8,2
11272,147,41,2743.0840740816866,3,5,3,11,1
11273,154,28,3037.2435217919437,3,3,4,10,1
11274,38,16,2367.425893535353,5,2,3,10,1
11275,131,35,4556.599346253358,4,4,5,13,0
11276,358,36,3701.1875644979787,1,4,4,9,2
11277,255,35,3365.827358117576,2,4,4,10,1
11278,208,45,2605.2651754631793,3,5,3,11,1
11279,95,19,433.38817639432426,4,2,1,7,2
11280,348,21,548.028674324282,1,3,1,5,3
11281,327,33,1502.054222597656,1,4,2,7,2
11282,171,23,1065.496119160878,3,3,2,8,2
11283,250,6,4763.129549820892,2,1,5,8,2
11284,190,32,2054.964468072143,3,4,3,10,1
11285,199,22,4384.261138907173,3,3,5,11,1
11286,221,3,4092.2176214944952,2,1,5,8,2
11287,24,35,4064.7256609581036,5,4,5,14,0
11288,244,16,1086.3805504827892,2,2,2,6,3
11289,324,42,2242.135846874069,1,5,3,9,2
11290,128,25,1596.580438319226,4,3,2,9,2
11291,93,17,4852.35090915621,4,2,5,11,1
11292,300,39,4384.954063465393,1,4,5,10,1
11293,133,13,1257.1190682557342,4,2,2,8,2
11294,55,28,1574.466600442706,5,3,2,10,1
11295,158,11,2649.257095513344,3,2,3,8,2
11296,29,10,1400.2428678055996,5,1,2,8,2
11297,211,39,4124.404533268687,3,4,5,12,1
11298,154,24,4097.964076745007,3,3,5,11,1
11299,293,38,3624.458784768034,1,4,4,9,2
11300,222,24,3449.6579217326553,2,3,4,9,2
11301,115,33,2741.034522399758,4,4,3,11,1
11302,158,17,1742.0901629705031,3,2,2,7,2
11303,259,44,4186.32287933848,2,5,5,12,1
11304,251,36,4295.572534546344,2,4,5,11,1
11305,122,35,257.05224963219536,4,4,1,9,2
11306,299,6,1999.1108754811557,1,1,2,4,3
11307,263,16,142.8716264466203,2,2,1,5,3
11308,49,45,4198.992199551177,5,5,5,15,0
11309,329,28,893.6953001449888,1,3,1,5,3
11310,297,41,3372.595156434498,1,5,4,10,1
11311,362,32,1793.3053302949063,1,4,2,7,2
11312,77,26,4082.1666116285037,4,3,5,12,1
11313,127,11,2553.337632266285,4,2,3,9,2
11314,197,25,1628.7656030132684,3,3,2,8,2
11315,221,31,1626.1146295811948,2,4,2,8,2
11316,91,21,1641.3669396836738,4,3,2,9,2
11317,8,45,3945.010292427322,5,5,4,14,0
11318,32,3,3558.466838145101,5,1,4,10,1
11319,320,12,1602.8783956591997,1,2,2,5,3
11320,269,40,2456.1383638285793,2,4,3,9,2
11321,191,46,390.00539379133363,3,5,1,9,2
11322,349,41,4139.226339113521,1,5,5,11,1
11323,163,25,1337.1144991242923,3,3,2,8,2
11324,61,17,4447.233457775097,5,2,5,12,1
11325,264,38,2988.015498134501,2,4,3,9,2
11326,285,36,2843.4226094580513,2,4,3,9,2
11327,95,36,821.9665241479656,4,4,1,9,2
11328,41,19,356.98144435418203,5,2,1,8,2
11329,149,44,2767.5567390993156,3,5,3,11,1
11330,204,2,2345.2657250435677,3,1,3,7,2
11331,267,17,607.2183375505405,2,2,1,5,3
11332,2,30,4179.582735365751,5,3,5,13,0
11333,178,47,2092.028194686818,3,5,3,11,1
11334,194,10,1309.6844239505258,3,1,2,6,3
11335,336,35,3943.477744800478,1,4,4,9,2
11336,196,36,4566.190142316916,3,4,5,12,1
11337,343,33,1536.7538889133104,1,4,2,7,2
11338,249,1,3881.98992815422,2,1,4,7,2
11339,212,18,3266.073088472482,3,2,4,9,2
11340,153,4,4948.741640932918,3,1,5,9,2
11341,158,47,1027.9236099820255,3,5,2,10,1
11342,362,27,4803.788182587207,1,3,5,9,2
11343,139,25,1583.2075629823494,4,3,2,9,2
11344,221,28,2065.651947374152,2,3,3,8,2
11345,273,22,1800.5408125862189,2,3,2,7,2
11346,154,42,1349.5689784709957,3,5,2,10,1
11347,249,25,3469.180681337165,2,3,4,9,2
11348,279,17,2949.8351504219645,2,2,3,7,2
11349,304,44,1535.4028090035613,1,5,2,8,2
11350,276,12,669.7401580261986,2,2,1,5,3
11351,2,16,1593.7044322887018,5,2,2,9,2
11352,88,37,1912.3442453024106,4,4,2,10,1
11353,287,16,1909.4606811741396,2,2,2,6,3
11354,130,17,1792.7250734753263,4,2,2,8,2
11355,78,31,253.1253060534531,4,4,1,9,2
11356,260,15,2325.52520842857,2,2,3,7,2
11357,241,13,4182.678405254082,2,2,5,9,2
11358,141,40,910.0277963740073,4,4,1,9,2
11359,228,27,736.8301437029892,2,3,1,6,3
11360,163,21,2364.536765671608,3,3,3,9,2
11361,236,2,1859.3090306285571,2,1,2,5,3
11362,128,8,2810.790397160619,4,1,3,8,2
11363,200,42,4735.900805218316,3,5,5,13,0
11364,31,7,3806.8223891606954,5,1,4,10,1
11365,138,10,3438.420184374676,4,1,4,9,2
11366,21,4,2085.5253525244566,5,1,3,9,2
11367,234,43,1443.925583544358,2,5,2,9,2
11368,202,41,2705.917875446445,3,5,3,11,1
11369,279,36,4428.363203029799,2,4,5,11,1
11370,131,35,4384.945127451744,4,4,5,13,0
11371,148,43,2233.1195942585937,3,5,3,11,1
11372,29,3,1238.6395626503174,5,1,2,8,2
11373,361,18,1134.4688067518696,1,2,2,5,3
11374,308,46,179.6021996292836,1,5,1,7,2
11375,162,43,4214.894589016773,3,5,5,13,0
11376,357,24,1331.541788828107,1,3,2,6,3
11377,340,32,1801.4057136207718,1,4,2,7,2
11378,61,34,4047.9885432609817,5,4,5,14,0
11379,125,2,608.920018346823,4,1,1,6,3
11380,71,2,2311.558053283354,5,1,3,9,2
11381,326,10,620.4834858074511,1,1,1,3,3
11382,364,23,2214.8243618615097,1,3,3,7,2
11383,243,15,245.22647240737658,2,2,1,5,3
11384,249,12,2592.937901807141,2,2,3,7,2
11385,221,43,3980.59149816623,2,5,4,11,1
11386,21,17,3384.7204072078407,5,2,4,11,1
11387,82,18,2550.7533577912286,4,2,3,9,2
11388,344,14,4145.505973624285,1,2,5,8,2
11389,10,17,1146.661995046373,5,2,2,9,2
11390,12,15,4155.673462071551,5,2,5,12,1
11391,263,12,1389.0537631449986,2,2,2,6,3
11392,145,16,1818.8068425918016,4,2,2,8,2
11393,192,32,650.8667062858574,3,4,1,8,2
11394,250,23,517.7562342474721,2,3,1,6,3
11395,114,38,4661.236478740044,4,4,5,13,0
11396,26,34,957.991453453037,5,4,1,10,1
11397,271,34,1673.147813759119,2,4,2,8,2
11398,33,16,2650.4669777601666,5,2,3,10,1
11399,62,34,1745.8569916896113,5,4,2,11,1
11400,229,40,4351.965084060107,2,4,5,11,1
11401,303,7,4504.566669599394,1,1,5,7,2
11402,95,33,1636.692382393668,4,4,2,10,1
11403,35,4,469.2182038719002,5,1,1,7,2
11404,193,43,1058.6895876958133,3,5,2,10,1
11405,76,7,2377.220674467969,4,1,3,8,2
11406,249,18,1449.520400746302,2,2,2,6,3
11407,83,4,2272.8264652824096,4,1,3,8,2
11408,25,49,3795.9304636071543,5,5,4,14,0
11409,57,11,2108.985784540686,5,2,3,10,1
11410,32,43,993.0173064776137,5,5,1,11,1
11411,319,20,1796.2585265188125,1,2,2,5,3
11412,12,11,3717.47627856118,5,2,4,11,1
11413,319,15,2126.0699798667515,1,2,3,6,3
11414,333,46,1255.1938863254825,1,5,2,8,2
11415,92,17,2142.7840796445857,4,2,3,9,2
11416,1,34,2279.485371536472,5,4,3,12,1
11417,326,48,1488.9222518374706,1,5,2,8,2
11418,136,12,4978.468595073264,4,2,5,11,1
11419,196,42,3840.4538342544,3,5,4,12,1
11420,133,28,3465.350384900925,4,3,4,11,1
11421,86,48,4275.786253005019,4,5,5,14,0
11422,295,35,3335.4317868695757,1,4,4,9,2
11423,279,8,3956.9919118450093,2,1,4,7,2
11424,324,27,2068.5029661484277,1,3,3,7,2
11425,180,22,2506.8551318475456,3,3,3,9,2
11426,4,24,244.51195268121845,5,3,1,9,2
11427,126,2,1410.4254931299906,4,1,2,7,2
11428,175,31,1846.3819220742469,3,4,2,9,2
11429,251,22,3131.0964248424552,2,3,4,9,2
11430,21,1,2326.414311121578,5,1,3,9,2
11431,105,14,3043.112929492264,4,2,4,10,1
11432,66,25,3569.5033992242697,5,3,4,12,1
11433,263,36,223.16615166167588,2,4,1,7,2
11434,49,36,1298.8059575480363,5,4,2,11,1
11435,16,41,862.8103239982146,5,5,1,11,1
11436,145,3,945.4010446631465,4,1,1,6,3
11437,340,5,2520.595724203638,1,1,3,5,3
11438,250,1,3702.494094734627,2,1,4,7,2
11439,343,19,1371.1573992876329,1,2,2,5,3
11440,354,33,4124.001698297204,1,4,5,10,1
11441,75,42,4463.358020870784,4,5,5,14,0
11442,290,30,1759.1640213815583,2,3,2,7,2
11443,282,12,3409.969129381584,2,2,4,8,2
11444,66,10,594.0759774846895,5,1,1,7,2
11445,125,34,3722.7011445742514,4,4,4,12,1
11446,319,16,833.4691386283278,1,2,1,4,3
11447,87,40,3440.204860817394,4,4,4,12,1
11448,41,46,2115.2810172663203,5,5,3,13,0
11449,186,29,4642.997044876518,3,3,5,11,1
11450,354,15,2327.6583033436623,1,2,3,6,3
11451,335,48,164.20505916329762,1,5,1,7,2
11452,266,11,2408.5384908670258,2,2,3,7,2
11453,271,44,3979.5387318613657,2,5,4,11,1
11454,42,34,3238.9508111253813,5,4,4,13,0
11455,93,36,4831.912831107224,4,4,5,13,0
11456,185,30,4217.929725423081,3,3,5,11,1
11457,215,35,2637.492797858839,3,4,3,10,1
11458,17,9,1040.5376223709366,5,1,2,8,2
11459,265,18,28.835402812394097,2,2,1,5,3
11460,114,19,4902.706961036827,4,2,5,11,1
11461,292,39,4692.215294530324,1,4,5,10,1
11462,292,4,1377.9785304352124,1,1,2,4,3
11463,48,6,3194.696773256398,5,1,4,10,1
11464,307,33,3648.9054188019068,1,4,4,9,2
11465,97,32,2894.287170552649,4,4,3,11,1
11466,95,16,4216.3787574421085,4,2,5,11,1
11467,326,11,398.34499567574863,1,2,1,4,3
11468,74,22,4483.505230409565,4,3,5,12,1
11469,336,36,1966.1748657207954,1,4,2,7,2
11470,68,23,2408.6432076582096,5,3,3,11,1
11471,246,26,2229.220915604144,2,3,3,8,2
11472,77,31,2661.118252617081,4,4,3,11,1
11473,208,29,2994.86067470991,3,3,3,9,2
11474,254,5,3554.6137305661678,2,1,4,7,2
11475,221,38,2629.4522919852684,2,4,3,9,2
11476,262,25,3427.0185474843624,2,3,4,9,2
11477,331,34,1698.104243517596,1,4,2,7,2
11478,344,12,4684.037542587354,1,2,5,8,2
11479,259,22,332.0097888008481,2,3,1,6,3
11480,308,9,2732.247636719857,1,1,3,5,3
11481,74,20,446.10691834835626,4,2,1,7,2
11482,125,29,2219.4075098242824,4,3,3,10,1
11483,188,44,1295.335964687621,3,5,2,10,1
11484,254,29,4685.148213417411,2,3,5,10,1
11485,321,45,75.24617806585762,1,5,1,7,2
11486,308,27,1962.1061193958708,1,3,2,6,3
11487,235,17,3912.393321037703,2,2,4,8,2
11488,250,5,950.4224491308141,2,1,1,4,3
11489,332,45,4079.785141284602,1,5,5,11,1
11490,345,13,4300.028188245871,1,2,5,8,2
11491,72,42,3542.9349682323927,5,5,4,14,0
11492,235,15,1053.2552203065923,2,2,2,6,3
11493,324,15,1367.4728963419961,1,2,2,5,3
11494,156,18,843.0042961898562,3,2,1,6,3
11495,115,2,928.4780486349844,4,1,1,6,3
11496,313,23,192.0965594121229,1,3,1,5,3
11497,228,43,4288.00225517935,2,5,5,12,1
11498,322,13,2647.2264142649005,1,2,3,6,3
11499,346,43,1645.5185271963874,1,5,2,8,2
11500,245,4,1454.9892103564061,2,1,2,5,3
11501,306,47,2728.034519273456,1,5,3,9,2
11502,14,25,1640.1572607318458,5,3,2,10,1
11503,16,11,4319.952695301637,5,2,5,12,1
11504,42,48,1062.677600834185,5,5,2,12,1
11505,110,42,4412.685939150135,4,5,5,14,0
11506,278,12,3323.8213404871112,2,2,4,8,2
11507,324,13,4783.5798100703005,1,2,5,8,2
11508,19,9,85.38513576211024,5,1,1,7,2
11509,66,45,304.88687289867084,5,5,1,11,1
11510,167,38,2509.4640237435,3,4,3,10,1
11511,73,6,4562.770361859922,5,1,5,11,1
11512,310,43,3656.6668081354237,1,5,4,10,1
11513,112,43,3114.458303271473,4,5,4,13,0
11514,274,10,167.69475674431698,2,1,1,4,3
11515,85,23,1777.2773041789205,4,3,2,9,2
11516,139,15,1735.8059355852577,4,2,2,8,2
11517,39,45,2715.0075544769297,5,5,3,13,0
11518,105,23,1296.5606189403416,4,3,2,9,2
11519,324,40,1343.1070187370226,1,4,2,7,2
11520,281,37,3108.0953923830293,2,4,4,10,1
11521,123,34,4723.392041137641,4,4,5,13,0
11522,218,16,3304.2937271471096,2,2,4,8,2
11523,61,45,3343.9693186653653,5,5,4,14,0
11524,100,41,4931.211918806696,4,5,5,14,0
11525,307,47,775.8560536782527,1,5,1,7,2
11526,354,32,178.83552325979844,1,4,1,6,3
11527,204,38,3730.114614224028,3,4,4,11,1
11528,258,40,2199.5492916174617,2,4,3,9,2
11529,5,46,2149.828540212511,5,5,3,13,0
11530,197,5,1134.2638480515313,3,1,2,6,3
11531,180,17,2539.246572190002,3,2,3,8,2
11532,342,22,2216.4399951871173,1,3,3,7,2
11533,133,39,1733.7955391531798,4,4,2,10,1
11534,324,41,2219.29834509871,1,5,3,9,2
11535,253,48,1925.3355059072203,2,5,2,9,2
11536,265,18,4700.082826866787,2,2,5,9,2
11537,93,28,4901.4557708044185,4,3,5,12,1
11538,150,13,4201.105653233652,3,2,5,10,1
11539,138,42,4952.166314150503,4,5,5,14,0
11540,208,1,1335.9399508556082,3,1,2,6,3
11541,125,19,4216.196298495509,4,2,5,11,1
11542,234,34,2039.0787693940788,2,4,3,9,2
11543,61,4,3733.2206249109895,5,1,4,10,1
11544,307,43,1014.9492767460615,1,5,1,7,2
11545,266,3,4061.6608878091233,2,1,5,8,2
11546,134,41,426.4874865230284,4,5,1,10,1
11547,318,10,1360.0829565148542,1,1,2,4,3
11548,113,28,4111.543558067307,4,3,5,12,1
11549,191,34,3738.324516891039,3,4,4,11,1
11550,187,39,2511.2213074065335,3,4,3,10,1
11551,319,47,3367.2359437081423,1,5,4,10,1
11552,89,19,936.0143822346889,4,2,1,7,2
11553,187,42,3342.140475507937,3,5,4,12,1
11554,307,46,49.80107503404775,1,5,1,7,2
11555,132,36,4167.747178233715,4,4,5,13,0
11556,360,43,2586.2751639147286,1,5,3,9,2
11557,123,3,4719.953473531813,4,1,5,10,1
11558,48,23,2396.0396939406814,5,3,3,11,1
11559,288,17,2171.105538808442,2,2,3,7,2
11560,179,7,2255.763533865092,3,1,3,7,2
11561,180,26,1805.0458151737273,3,3,2,8,2
11562,99,43,841.7086683748432,4,5,1,10,1
11563,330,18,4211.893007458073,1,2,5,8,2
11564,34,46,1951.536184713891,5,5,2,12,1
11565,70,46,2650.251056662404,5,5,3,13,0
11566,171,6,109.2357131525478,3,1,1,5,3
11567,272,31,310.66682484285536,2,4,1,7,2
11568,59,29,2989.9443150944444,5,3,3,11,1
11569,181,9,4397.348131742908,3,1,5,9,2
11570,19,35,2472.045181850112,5,4,3,12,1
11571,226,17,833.2231572192659,2,2,1,5,3
11572,95,12,589.4752986861848,4,2,1,7,2
11573,297,36,4499.94212695069,1,4,5,10,1
11574,81,48,3511.1728915361327,4,5,4,13,0
11575,175,24,4831.3158170121715,3,3,5,11,1
11576,222,10,420.91962050605923,2,1,1,4,3
11577,103,30,4514.0381465668315,4,3,5,12,1
11578,54,29,4229.705239508811,5,3,5,13,0
11579,183,39,4466.994062791527,3,4,5,12,1
11580,351,10,38.75715346962634,1,1,1,3,3
11581,318,39,3712.0983678307016,1,4,4,9,2
11582,355,28,2749.2011896665786,1,3,3,7,2
11583,349,18,2870.1653744545147,1,2,3,6,3
11584,321,41,2351.3179168902507,1,5,3,9,2
11585,68,17,3715.9578195636145,5,2,4,11,1
11586,28,11,4999.198059477259,5,2,5,12,1
11587,274,1,3555.5864127780756,2,1,4,7,2
11588,282,17,3393.4715760362214,2,2,4,8,2
11589,360,36,3275.6442012436037,1,4,4,9,2
11590,311,36,3479.1062325383145,1,4,4,9,2
11591,119,46,1717.141212479854,4,5,2,11,1
11592,134,9,1607.8965208954294,4,1,2,7,2
11593,129,45,3923.846511569827,4,5,4,13,0
11594,8,28,274.909206591298,5,3,1,9,2
11595,51,48,3798.6462136348855,5,5,4,14,0
11596,341,33,4071.0695099961467,1,4,5,10,1
11597,281,3,2612.773818335476,2,1,3,6,3
11598,175,8,4551.638996110946,3,1,5,9,2
11599,183,6,2370.706311364451,3,1,3,7,2
11600,192,6,898.6524737982635,3,1,1,5,3
11601,249,29,1813.3792570462974,2,3,2,7,2
11602,235,37,4530.27885459612,2,4,5,11,1
11603,83,12,4968.754058738691,4,2,5,11,1
11604,93,9,2115.051295277522,4,1,3,8,2
11605,312,41,842.5642625123527,1,5,1,7,2
11606,268,49,1438.7831083683477,2,5,2,9,2
11607,120,19,2770.9487491446803,4,2,3,9,2
11608,71,17,2864.7586322029615,5,2,3,10,1
11609,17,48,3153.996439400964,5,5,4,14,0
11610,253,44,4178.413329137009,2,5,5,12,1
11611,122,32,3558.9586169232584,4,4,4,12,1
11612,10,35,1311.5927302475095,5,4,2,11,1
11613,287,14,1981.269862873042,2,2,2,6,3
11614,316,49,4200.684753182028,1,5,5,11,1
11615,326,16,3170.579526322498,1,2,4,7,2
11616,273,21,840.4260607411703,2,3,1,6,3
11617,306,12,1634.4386323607896,1,2,2,5,3
11618,293,24,3957.5436530301977,1,3,4,8,2
11619,210,34,868.7496753836691,3,4,1,8,2
11620,218,8,3458.3427570766894,2,1,4,7,2
11621,241,44,2822.04731579555,2,5,3,10,1
11622,200,21,745.8997829417142,3,3,1,7,2
11623,216,48,3447.505830914373,3,5,4,12,1
11624,205,8,720.3213635692969,3,1,1,5,3
11625,216,28,1998.193539757309,3,3,2,8,2
11626,80,16,1549.7140233773564,4,2,2,8,2
11627,267,10,3453.1496639079182,2,1,4,7,2
11628,35,15,3913.988159467195,5,2,4,11,1
11629,289,4,849.8997439600083,2,1,1,4,3
11630,18,26,4061.8637455687194,5,3,5,13,0
11631,165,15,45.99813941284353,3,2,1,6,3
11632,13,36,2654.99215123924,5,4,3,12,1
11633,202,32,2588.776560474623,3,4,3,10,1
11634,229,43,3122.8689394515804,2,5,4,11,1
11635,346,38,1206.1056463700281,1,4,2,7,2
11636,1,4,59.185581351705125,5,1,1,7,2
11637,319,41,2279.266951545583,1,5,3,9,2
11638,217,9,366.3169941786901,3,1,1,5,3
11639,34,35,4462.047495166272,5,4,5,14,0
11640,359,28,876.5949651889753,1,3,1,5,3
11641,266,37,2131.912507818316,2,4,3,9,2
11642,128,47,2175.661947299515,4,5,3,12,1
11643,212,9,2768.7945927126416,3,1,3,7,2
11644,263,2,3914.8364203642823,2,1,4,7,2
11645,312,3,2366.01927103881,1,1,3,5,3
11646,80,44,138.5088034301608,4,5,1,10,1
11647,165,48,3857.8409517636965,3,5,4,12,1
11648,252,5,420.0448399582486,2,1,1,4,3
11649,12,10,3211.350928371732,5,1,4,10,1
11650,304,28,4019.1132481729583,1,3,5,9,2
11651,212,15,1420.6239606804083,3,2,2,7,2
11652,282,14,2251.041343603316,2,2,3,7,2
11653,112,46,81.53585250722497,4,5,1,10,1
11654,211,23,4021.337245953528,3,3,5,11,1
11655,239,13,3519.2728387048883,2,2,4,8,2
11656,268,16,1164.6230979953368,2,2,2,6,3
11657,298,30,1957.2287273502884,1,3,2,6,3
11658,317,40,3479.629343987546,1,4,4,9,2
11659,58,8,1797.2339780375214,5,1,2,8,2
11660,34,17,820.4497300329219,5,2,1,8,2
11661,263,30,2597.3425891007623,2,3,3,8,2
11662,35,17,3620.6021757293347,5,2,4,11,1
11663,271,35,1610.8394399446997,2,4,2,8,2
11664,227,1,617.6436355058445,2,1,1,4,3
11665,25,49,4149.425367441764,5,5,5,15,0
11666,234,24,1271.4813135711443,2,3,2,7,2
11667,59,48,2568.9466209919665,5,5,3,13,0
11668,251,49,3459.8023159513227,2,5,4,11,1
11669,335,25,1592.2052499671615,1,3,2,6,3
11670,86,2,3246.6963214883676,4,1,4,9,2
11671,251,25,2303.9504371432263,2,3,3,8,2
11672,180,14,2856.478909067992,3,2,3,8,2
11673,207,39,2956.974757048544,3,4,3,10,1
11674,344,33,4122.511927615462,1,4,5,10,1
11675,149,17,3285.068104442329,3,2,4,9,2
11676,71,31,1328.8903940002083,5,4,2,11,1
11677,121,10,307.42566228084684,4,1,1,6,3
11678,253,6,19.907864934912368,2,1,1,4,3
11679,93,39,4523.042749987308,4,4,5,13,0
11680,256,25,4711.1291584930095,2,3,5,10,1
11681,254,38,479.61632344669295,2,4,1,7,2
11682,352,37,2440.397555228418,1,4,3,8,2
11683,288,30,766.460065268067,2,3,1,6,3
11684,309,34,4744.257942653382,1,4,5,10,1
11685,59,18,1241.6942589443934,5,2,2,9,2
11686,69,24,2513.219007029025,5,3,3,11,1
11687,86,49,836.4447567472546,4,5,1,10,1
11688,274,27,1670.477811670281,2,3,2,7,2
11689,227,27,1341.3637410266326,2,3,2,7,2
11690,81,39,2382.375954431206,4,4,3,11,1
11691,114,21,2104.7119904905207,4,3,3,10,1
11692,184,19,1660.6809950558727,3,2,2,7,2
11693,280,39,538.3293120655762,2,4,1,7,2
11694,322,23,2427.5902398146713,1,3,3,7,2
11695,318,39,4252.538010276846,1,4,5,10,1
11696,54,48,3653.8144495619745,5,5,4,14,0
11697,197,44,3605.6686719717204,3,5,4,12,1
11698,293,47,1836.7977663590905,1,5,2,8,2
11699,293,15,3545.0112126034364,1,2,4,7,2
11700,291,43,2333.002092185594,2,5,3,10,1
11701,180,2,759.8776932824647,3,1,1,5,3
11702,222,35,2101.0582523904745,2,4,3,9,2
11703,274,20,672.3657688476712,2,2,1,5,3
11704,244,28,581.269266343614,2,3,1,6,3
11705,154,15,125.06594920347753,3,2,1,6,3
11706,304,16,1421.4429618373886,1,2,2,5,3
11707,273,33,1661.0651733673046,2,4,2,8,2
11708,135,47,3500.224127563078,4,5,4,13,0
11709,313,12,2694.6438765750704,1,2,3,6,3
11710,8,39,4293.664063146027,5,4,5,14,0
11711,128,39,890.5884272612259,4,4,1,9,2
11712,56,43,1337.123662840472,5,5,2,12,1
11713,126,20,4705.969794605644,4,2,5,11,1
11714,159,29,2225.7857864212738,3,3,3,9,2
11715,59,43,3947.364205812792,5,5,4,14,0
11716,58,49,2465.916566760951,5,5,3,13,0
11717,140,3,2360.71742855848,4,1,3,8,2
11718,176,48,749.1002772679155,3,5,1,9,2
11719,108,5,4257.486058633445,4,1,5,10,1
11720,211,2,400.9928499326968,3,1,1,5,3
11721,74,23,1558.2028623186773,4,3,2,9,2
11722,167,26,3370.605677883695,3,3,4,10,1
11723,357,26,2541.215178532069,1,3,3,7,2
11724,304,7,4408.077851587966,1,1,5,7,2
11725,233,10,206.09678441170047,2,1,1,4,3
11726,327,5,3250.543522303654,1,1,4,6,3
11727,182,47,2392.552698429353,3,5,3,11,1
11728,122,12,780.0159991035781,4,2,1,7,2
11729,334,32,3718.8270164918413,1,4,4,9,2
11730,203,42,2062.4212084760597,3,5,3,11,1
11731,29,31,2662.5937021410505,5,4,3,12,1
11732,202,22,4836.65767115191,3,3,5,11,1
11733,93,17,2436.2881043156913,4,2,3,9,2
11734,329,20,4118.6305991376275,1,2,5,8,2
11735,356,20,3850.191841472809,1,2,4,7,2
11736,176,43,3317.145411653857,3,5,4,12,1
11737,330,8,4485.092595318165,1,1,5,7,2
11738,211,47,1265.4922182165326,3,5,2,10,1
11739,184,34,4105.648445023639,3,4,5,12,1
11740,95,49,1895.1595671027394,4,5,2,11,1
11741,273,23,4064.3295415052944,2,3,5,10,1
11742,137,38,2474.0055358821,4,4,3,11,1
11743,237,28,4289.969172186747,2,3,5,10,1
11744,353,13,4475.269253088001,1,2,5,8,2
11745,265,29,2992.2429396637363,2,3,3,8,2
11746,135,8,2543.058514587912,4,1,3,8,2
11747,144,11,3918.567915228348,4,2,4,10,1
11748,19,47,1342.261153864075,5,5,2,12,1
11749,231,45,86.58991943208295,2,5,1,8,2
11750,134,18,2041.4019679463,4,2,3,9,2
11751,114,25,2543.7929231549165,4,3,3,10,1
11752,139,49,1493.340969999395,4,5,2,11,1
11753,125,22,1922.9757898714595,4,3,2,9,2
11754,204,45,673.9605822513123,3,5,1,9,2
11755,61,35,1393.6766178052922,5,4,2,11,1
11756,250,29,1208.075786093722,2,3,2,7,2
11757,298,21,1511.9244005955832,1,3,2,6,3
11758,13,7,1502.2800115978557,5,1,2,8,2
11759,255,12,2799.252171527591,2,2,3,7,2
11760,85,36,1260.4787315784029,4,4,2,10,1
11761,20,24,4705.396704066044,5,3,5,13,0
11762,50,32,2561.261403513041,5,4,3,12,1
11763,164,27,653.5403719847394,3,3,1,7,2
11764,92,32,1405.2352899161765,4,4,2,10,1
11765,88,32,3651.4899057169137,4,4,4,12,1
11766,69,32,78.15860151983003,5,4,1,10,1
11767,37,26,4689.711751122785,5,3,5,13,0
11768,253,11,2231.4328394117724,2,2,3,7,2
11769,252,46,2610.1843245254736,2,5,3,10,1
11770,140,18,4942.177056839245,4,2,5,11,1
11771,355,39,2521.9813991366645,1,4,3,8,2
11772,168,5,4739.242532365243,3,1,5,9,2
11773,54,16,4577.00326780784,5,2,5,12,1
11774,178,11,4707.164488044401,3,2,5,10,1
11775,297,35,4063.741556886896,1,4,5,10,1
11776,301,48,1489.0264419430787,1,5,2,8,2
11777,359,11,1738.4485940920474,1,2,2,5,3
11778,106,42,1831.270500221398,4,5,2,11,1
11779,137,23,4896.112389664854,4,3,5,12,1
11780,190,34,1810.1699648210215,3,4,2,9,2
11781,128,48,552.3596529997186,4,5,1,10,1
11782,342,17,3893.8611842294067,1,2,4,7,2
11783,47,10,1836.6558249944421,5,1,2,8,2
11784,5,18,3108.4701995119585,5,2,4,11,1
11785,257,44,4622.558457197196,2,5,5,12,1
11786,300,8,2881.772828122441,1,1,3,5,3
11787,150,26,3192.123890005861,3,3,4,10,1
11788,294,3,3217.8841966810287,1,1,4,6,3
11789,243,24,3065.871936934991,2,3,4,9,2
11790,275,3,807.2491936299609,2,1,1,4,3
11791,208,38,2287.51291959629,3,4,3,10,1
11792,115,2,48.24345968552169,4,1,1,6,3
11793,195,35,3135.0613723359124,3,4,4,11,1
11794,343,17,2881.0378921809324,1,2,3,6,3
11795,170,9,1597.5047240116971,3,1,2,6,3
11796,82,36,2624.2385608193167,4,4,3,11,1
11797,154,22,2470.358331721303,3,3,3,9,2
11798,141,31,1262.0669275518335,4,4,2,10,1
11799,314,34,1473.5048649820387,1,4,2,7,2
11800,146,24,3815.0795731774656,4,3,4,11,1
11801,323,9,3781.1042727168274,1,1,4,6,3
11802,122,46,2354.2129296968133,4,5,3,12,1
11803,252,43,3590.369672555738,2,5,4,11,1
11804,343,2,2259.4983883523714,1,1,3,5,3
11805,311,21,4258.356434131699,1,3,5,9,2
11806,89,34,1670.7053442209804,4,4,2,10,1
11807,58,27,4637.1895742285515,5,3,5,13,0
11808,63,37,2715.9954163177076,5,4,3,12,1
11809,347,7,2683.082426787956,1,1,3,5,3
11810,308,22,3357.343817786958,1,3,4,8,2
11811,280,4,1710.8714939652752,2,1,2,5,3
11812,72,14,3624.4045588266004,5,2,4,11,1
11813,9,34,1608.9212621442584,5,4,2,11,1
11814,94,23,1993.7187614943405,4,3,2,9,2
11815,339,44,3376.7701495973533,1,5,4,10,1
11816,336,42,1898.4610154938932,1,5,2,8,2
11817,152,25,1007.8708722134229,3,3,1,7,2
11818,356,1,4360.788279289779,1,1,5,7,2
11819,40,48,4611.555350161492,5,5,5,15,0
11820,359,15,3137.3879385391683,1,2,4,7,2
11821,62,32,4057.642348277289,5,4,5,14,0
11822,254,14,4933.395250326017,2,2,5,9,2
11823,69,41,3077.7260115809304,5,5,4,14,0
11824,245,21,4544.875289817567,2,3,5,10,1
11825,170,47,1802.6812011045347,3,5,2,10,1
11826,178,7,3505.3574550770586,3,1,4,8,2
11827,189,36,288.4692768212633,3,4,1,8,2
11828,260,21,3946.9680624946227,2,3,4,9,2
11829,72,40,4150.717692200541,5,4,5,14,0
11830,17,12,2011.8654280052197,5,2,3,10,1
11831,341,15,3198.385529227875,1,2,4,7,2
11832,57,15,4293.22190093787,5,2,5,12,1
11833,218,17,4419.204740900161,2,2,5,9,2
11834,107,34,541.5923063398387,4,4,1,9,2
11835,304,44,4139.163855199158,1,5,5,11,1
11836,173,35,1378.4743261112403,3,4,2,9,2
11837,219,39,3639.2614127253396,2,4,4,10,1
11838,247,38,1632.5691259278512,2,4,2,8,2
11839,218,14,291.0850564465799,2,2,1,5,3
11840,31,5,1057.2548421570268,5,1,2,8,2
11841,47,30,2049.272161377149,5,3,3,11,1
11842,134,4,3708.730814104602,4,1,4,9,2
11843,108,15,512.5111002886645,4,2,1,7,2
11844,72,39,4066.5412832517973,5,4,5,14,0
11845,327,35,4984.785948892429,1,4,5,10,1
11846,108,45,3943.4056394638355,4,5,4,13,0
11847,309,10,2373.9452349441185,1,1,3,5,3
11848,272,2,2845.1194521212724,2,1,3,6,3
11849,171,44,40.74093643034606,3,5,1,9,2
11850,116,24,1054.2764508984333,4,3,2,9,2
11851,329,28,4495.950775985627,1,3,5,9,2
11852,74,22,118.42971964857747,4,3,1,8,2
11853,256,44,4524.926814955939,2,5,5,12,1
11854,81,32,575.1305145595553,4,4,1,9,2
11855,268,31,674.0399084945831,2,4,1,7,2
11856,128,19,884.9960551760429,4,2,1,7,2
11857,326,21,3998.9327715264294,1,3,4,8,2
11858,235,3,2396.1510109584733,2,1,3,6,3
11859,41,6,734.5311848479114,5,1,1,7,2
11860,181,32,3437.1410801299717,3,4,4,11,1
11861,157,2,4704.034947965629,3,1,5,9,2
11862,59,24,2866.5328564948845,5,3,3,11,1
11863,345,45,502.5130285454871,1,5,1,7,2
11864,249,27,283.2055248259236,2,3,1,6,3
11865,192,9,3981.403075780046,3,1,4,8,2
11866,24,13,3134.1574253484305,5,2,4,11,1
11867,80,14,4614.060122231761,4,2,5,11,1
11868,134,11,2740.7782537294597,4,2,3,9,2
11869,213,14,321.3530621828363,3,2,1,6,3
11870,348,16,2024.3973814932647,1,2,3,6,3
11871,166,10,3293.3735360711753,3,1,4,8,2
11872,348,20,1930.5779011769428,1,2,2,5,3
11873,337,16,4997.961069733763,1,2,5,8,2
11874,71,34,2032.839282231988,5,4,3,12,1
11875,214,16,2735.718270973275,3,2,3,8,2
11876,65,14,1134.7062427921605,5,2,2,9,2
11877,221,28,769.1696394679367,2,3,1,6,3
11878,308,18,3230.074637430622,1,2,4,7,2
11879,286,26,2947.1776071092536,2,3,3,8,2
11880,185,38,31.650898457358448,3,4,1,8,2
11881,207,7,1431.0598586407334,3,1,2,6,3
11882,99,45,3221.4620693344427,4,5,4,13,0
11883,242,34,4063.124235204924,2,4,5,11,1
11884,158,47,1568.719578668823,3,5,2,10,1
11885,98,49,3240.7074827513807,4,5,4,13,0
11886,42,45,1333.6370714527225,5,5,2,12,1
11887,139,7,3454.9956741998885,4,1,4,9,2
11888,283,33,3492.760513325688,2,4,4,10,1
11889,227,35,659.8150929427545,2,4,1,7,2
11890,72,39,3328.7980220452546,5,4,4,13,0
11891,243,21,1674.5002365850448,2,3,2,7,2
11892,18,49,871.2487086472107,5,5,1,11,1
11893,77,28,2506.802551541133,4,3,3,10,1
11894,45,32,2266.960452704519,5,4,3,12,1
11895,343,44,3871.635307199365,1,5,4,10,1
11896,140,16,431.73239071448046,4,2,1,7,2
11897,177,10,3950.8688114705865,3,1,4,8,2
11898,222,23,539.3509869253854,2,3,1,6,3
11899,92,48,1045.220550114519,4,5,2,11,1
11900,22,15,2584.251770465058,5,2,3,10,1
11901,172,43,2321.2412541118983,3,5,3,11,1
11902,92,6,4944.4062839229,4,1,5,10,1
11903,192,33,2951.4738291795725,3,4,3,10,1
11904,77,39,1643.9036202821003,4,4,2,10,1
11905,281,12,4501.742854034488,2,2,5,9,2
11906,364,36,1567.9526343446933,1,4,2,7,2
11907,179,31,1376.1404195895675,3,4,2,9,2
11908,238,10,2476.915258042309,2,1,3,6,3
11909,135,34,4566.742174520665,4,4,5,13,0
11910,280,41,3545.4861337416046,2,5,4,11,1
11911,19,10,3390.6412451819792,5,1,4,10,1
11912,83,11,3633.1255525434267,4,2,4,10,1
11913,228,14,3301.606647771682,2,2,4,8,2
11914,265,3,3801.38383474305,2,1,4,7,2
11915,112,33,971.8824884283761,4,4,1,9,2
11916,251,7,894.5188509403914,2,1,1,4,3
11917,164,4,1817.195085519105,3,1,2,6,3
11918,358,39,4256.289296191204,1,4,5,10,1
11919,168,48,3575.1265353285817,3,5,4,12,1
11920,221,10,2836.701980785418,2,1,3,6,3
11921,304,15,107.04271301581797,1,2,1,4,3
11922,191,16,1186.653396839974,3,2,2,7,2
11923,325,38,4019.5345733239956,1,4,5,10,1
11924,170,4,1220.0085984902512,3,1,2,6,3
11925,45,4,3654.1480839828273,5,1,4,10,1
11926,14,36,931.3249820001212,5,4,1,10,1
11927,231,27,3035.7741154147993,2,3,4,9,2
11928,157,22,3144.7747198355037,3,3,4,10,1
11929,134,22,3762.3114661755435,4,3,4,11,1
11930,37,17,2197.328580469243,5,2,3,10,1
11931,53,45,3167.0467484365076,5,5,4,14,0
11932,18,34,2439.979245714222,5,4,3,12,1
11933,38,32,4737.216846537582,5,4,5,14,0
11934,187,6,2614.184827822352,3,1,3,7,2
11935,196,33,1055.8934368096573,3,4,2,9,2
11936,243,8,3342.7838202017956,2,1,4,7,2
11937,300,36,2746.8519677599834,1,4,3,8,2
11938,303,5,4021.1091911285316,1,1,5,7,2
11939,35,5,892.7888719902855,5,1,1,7,2
11940,215,47,1312.088617342785,3,5,2,10,1
11941,219,10,4608.929245914634,2,1,5,8,2
11942,316,40,4650.830305099017,1,4,5,10,1
11943,90,7,2216.861264709706,4,1,3,8,2
11944,308,12,248.2783987709651,1,2,1,4,3
11945,252,30,1539.709792443539,2,3,2,7,2
11946,8,25,1243.1420455621778,5,3,2,10,1
11947,256,28,2079.2374914546594,2,3,3,8,2
11948,363,43,1595.825088204152,1,5,2,8,2
11949,208,13,4146.671795823747,3,2,5,10,1
11950,131,47,25.149735436015646,4,5,1,10,1
11951,224,49,3226.712949022376,2,5,4,11,1
11952,197,22,3324.708423528656,3,3,4,10,1
11953,142,18,3306.526610692324,4,2,4,10,1
11954,252,27,2607.767455767703,2,3,3,8,2
11955,96,8,3059.409324817917,4,1,4,9,2
11956,26,6,4054.36661457008,5,1,5,11,1
11957,111,11,3923.141925655023,4,2,4,10,1
11958,123,29,182.78063212026794,4,3,1,8,2
11959,186,41,161.87831332917125,3,5,1,9,2
11960,168,5,4196.3346157247515,3,1,5,9,2
11961,51,7,2877.9011407775088,5,1,3,9,2
11962,5,22,4787.562402993269,5,3,5,13,0
11963,77,47,2163.642068613214,4,5,3,12,1
11964,160,4,891.9416887647616,3,1,1,5,3
11965,208,32,2371.4422128151677,3,4,3,10,1
11966,257,19,2188.3560967280005,2,2,3,7,2
11967,205,45,2590.7151333781962,3,5,3,11,1
11968,255,33,4041.65669704598,2,4,5,11,1
11969,11,1,3281.3640998045125,5,1,4,10,1
11970,8,46,934.5238837228802,5,5,1,11,1
11971,32,41,3675.041509211756,5,5,4,14,0
11972,28,44,2963.5621042593734,5,5,3,13,0
11973,206,41,2895.77054538303,3,5,3,11,1
11974,228,8,3394.501843353819,2,1,4,7,2
11975,128,32,2824.187638696093,4,4,3,11,1
11976,255,30,2292.9935443270856,2,3,3,8,2
11977,212,46,3205.4976112423396,3,5,4,12,1
11978,239,28,3621.39807705737,2,3,4,9,2
11979,207,41,1136.5770447276411,3,5,2,10,1
11980,318,32,2490.2789722481816,1,4,3,8,2
11981,283,25,2296.280591692967,2,3,3,8,2
11982,245,34,209.11732035032855,2,4,1,7,2
11983,45,33,4173.848895555789,5,4,5,14,0
11984,105,13,1893.1362994527376,4,2,2,8,2
11985,348,25,372.71927367403185,1,3,1,5,3
11986,281,42,2294.916494411642,2,5,3,10,1
11987,234,40,815.7892223970706,2,4,1,7,2
11988,189,39,3525.0279290269773,3,4,4,11,1
11989,44,44,2863.140160086581,5,5,3,13,0
11990,225,49,1357.8678968198965,2,5,2,9,2
11991,142,44,4752.864557163361,4,5,5,14,0
11992,136,48,1465.809287795348,4,5,2,11,1
11993,176,10,2779.4345658148345,3,1,3,7,2
11994,142,31,4009.8234432123354,4,4,4,12,1
11995,80,44,2574.322566792895,4,5,3,12,1
11996,82,11,4804.6698221186725,4,2,5,11,1
11997,135,25,4220.834289227777,4,3,5,12,1
11998,207,46,4605.88487986447,3,5,5,13,0
11999,344,45,1869.7858929346505,1,5,2,8,2
12000,177,34,2746.2935328821804,3,4,3,10,1
12001,243,20,4202.429814512069,2,2,5,9,2
12002,55,7,4518.465171170702,5,1,5,11,1
12003,141,33,4722.374254062922,4,4,5,13,0
12004,56,35,4396.968446465981,5,4,5,14,0
12005,15,29,3656.4669713354187,5,3,4,12,1
12006,185,12,130.8318796043307,3,2,1,6,3
12007,314,5,1581.617712882561,1,1,2,4,3
12008,88,12,653.392061618218,4,2,1,7,2
12009,97,29,782.24542068734,4,3,1,8,2
12010,144,35,1461.6268650406312,4,4,2,10,1
12011,8,20,382.9548813708775,5,2,1,8,2
12012,215,37,1222.7287434978357,3,4,2,9,2
12013,173,1,4785.324394330313,3,1,5,9,2
12014,223,16,1566.5984571550969,2,2,2,6,3
12015,40,30,806.9682189208776,5,3,1,9,2
12016,182,9,3594.3179002948405,3,1,4,8,2
12017,270,42,4144.240698760726,2,5,5,12,1
12018,187,10,1577.0488694864528,3,1,2,6,3
12019,245,13,1399.7015797860709,2,2,2,6,3
12020,309,48,1216.3801440461173,1,5,2,8,2
12021,231,20,1972.373582941203,2,2,2,6,3
12022,155,29,445.2864716160701,3,3,1,7,2
12023,175,4,3348.9548405154696,3,1,4,8,2
12024,336,46,4112.90936302973,1,5,5,11,1
12025,115,49,3321.774575898698,4,5,4,13,0
12026,311,28,2111.7864525663117,1,3,3,7,2
12027,300,37,1451.921614247754,1,4,2,7,2
12028,18,13,2053.136360912753,5,2,3,10,1
12029,272,3,2124.9490495873715,2,1,3,6,3
12030,12,37,3333.4439340778104,5,4,4,13,0
12031,301,48,4641.021174696319,1,5,5,11,1
12032,192,19,362.22658234521504,3,2,1,6,3
12033,232,28,4767.234428489274,2,3,5,10,1
12034,93,19,4551.904404974552,4,2,5,11,1
12035,218,17,597.4841787110153,2,2,1,5,3
12036,278,18,926.0893051158159,2,2,1,5,3
12037,353,18,1564.8620512201453,1,2,2,5,3
12038,303,23,2802.7335444163077,1,3,3,7,2
12039,29,40,681.0362184322803,5,4,1,10,1
12040,301,9,1009.6714168267162,1,1,1,3,3
12041,77,29,4514.349716758999,4,3,5,12,1
12042,9,42,555.4101475469196,5,5,1,11,1
12043,24,29,2000.402543045304,5,3,2,10,1
12044,15,2,3817.3788705169563,5,1,4,10,1
12045,164,17,4444.0297532847835,3,2,5,10,1
12046,13,45,1686.8523873574725,5,5,2,12,1
12047,347,31,830.5431517342553,1,4,1,6,3
12048,172,28,3687.6881788868523,3,3,4,10,1
12049,357,43,3865.063215779151,1,5,4,10,1
12050,327,48,4900.366885862116,1,5,5,11,1
12051,200,39,706.3138387025872,3,4,1,8,2
12052,76,30,3550.0102045200615,4,3,4,11,1
12053,164,35,2092.28976329593,3,4,3,10,1
12054,61,48,4574.000893461597,5,5,5,15,0
12055,245,20,2045.076112823595,2,2,3,7,2
12056,155,16,2235.342274057704,3,2,3,8,2
12057,257,34,642.7150249518035,2,4,1,7,2
12058,244,14,1611.4745576034904,2,2,2,6,3
12059,162,26,2010.1939472574982,3,3,3,9,2
12060,68,20,97.36868434547615,5,2,1,8,2
12061,344,42,2193.496597529717,1,5,3,9,2
12062,277,24,1688.2295708238582,2,3,2,7,2
12063,161,43,4021.1602816444547,3,5,5,13,0
12064,259,18,544.4919410945067,2,2,1,5,3
12065,307,43,3803.453523345227,1,5,4,10,1
12066,335,9,3572.9176009509033,1,1,4,6,3
12067,95,19,1216.4938156376986,4,2,2,8,2
12068,246,20,425.5256250255676,2,2,1,5,3
12069,221,42,4210.748894320924,2,5,5,12,1
12070,123,30,1254.655913297118,4,3,2,9,2
12071,187,26,736.3449973384203,3,3,1,7,2
12072,262,31,1801.5926435468284,2,4,2,8,2
12073,273,35,2010.4052900586696,2,4,3,9,2
12074,60,3,1637.1790191026396,5,1,2,8,2
12075,125,40,4882.640751409686,4,4,5,13,0
12076,337,29,4405.295139788787,1,3,5,9,2
12077,341,6,4366.147727330853,1,1,5,7,2
12078,51,1,1999.850276698642,5,1,2,8,2
12079,178,24,4814.719502295082,3,3,5,11,1
12080,139,38,3423.2363284955713,4,4,4,12,1
12081,327,34,4161.653396838333,1,4,5,10,1
12082,170,7,2509.3668740212665,3,1,3,7,2
12083,39,11,811.4802930647683,5,2,1,8,2
12084,69,11,4435.558669873536,5,2,5,12,1
12085,236,36,2437.26942946715,2,4,3,9,2
12086,48,20,4843.088996335133,5,2,5,12,1
12087,57,16,1281.7564468985972,5,2,2,9,2
12088,277,5,4961.97116724181,2,1,5,8,2
12089,338,24,1119.8991630410237,1,3,2,6,3
12090,99,30,1847.1521225371125,4,3,2,9,2
12091,15,30,2974.142449395381,5,3,3,11,1
12092,325,39,3469.6820653306304,1,4,4,9,2
12093,179,48,3604.208023341972,3,5,4,12,1
12094,332,47,2386.4995205495848,1,5,3,9,2
12095,62,37,393.3665147518685,5,4,1,10,1
12096,119,33,2485.2802770633452,4,4,3,11,1
12097,37,20,1680.0928831566173,5,2,2,9,2
12098,134,22,3291.701489003429,4,3,4,11,1
12099,26,41,919.5551649869006,5,5,1,11,1
12100,8,21,1975.6225005092508,5,3,2,10,1
12101,4,37,4830.93457846266,5,4,5,14,0
12102,21,27,453.448322159209,5,3,1,9,2
12103,149,38,3015.64744812639,3,4,3,10,1
12104,25,35,462.3346629521934,5,4,1,10,1
12105,143,38,793.4083231403994,4,4,1,9,2
12106,245,40,3028.6225991791553,2,4,3,9,2
12107,43,6,2225.5376576631543,5,1,3,9,2
12108,293,32,2747.0099947813505,1,4,3,8,2
12109,185,16,4400.562131269513,3,2,5,10,1
12110,42,28,4088.028810129753,5,3,5,13,0
12111,92,16,4441.027432648279,4,2,5,11,1
12112,317,27,3085.1120549826796,1,3,4,8,2
12113,324,3,2453.319416872931,1,1,3,5,3
12114,53,49,2301.3959330823095,5,5,3,13,0
12115,84,21,3701.6446955499955,4,3,4,11,1
12116,34,38,2611.286392841565,5,4,3,12,1
12117,76,38,537.7862933484718,4,4,1,9,2
12118,353,30,718.275730050724,1,3,1,5,3
12119,197,22,1791.8430108923737,3,3,2,8,2
12120,286,19,348.4386261362316,2,2,1,5,3
12121,88,31,1203.7637851050517,4,4,2,10,1
12122,235,20,3285.440257535597,2,2,4,8,2
12123,232,47,72.02725836326033,2,5,1,8,2
12124,7,19,3024.423399251675,5,2,3,10,1
12125,292,2,3864.0610467771326,1,1,4,6,3
12126,38,40,859.0672201401758,5,4,1,10,1
12127,52,39,913.033130380019,5,4,1,10,1
12128,143,27,153.99326890226854,4,3,1,8,2
12129,221,8,2567.125693778973,2,1,3,6,3
12130,240,45,3276.391908794859,2,5,4,11,1
12131,143,27,2289.978814602248,4,3,3,10,1
12132,349,15,1953.3495600347967,1,2,2,5,3
12133,363,12,2277.5199582953996,1,2,3,6,3
12134,49,47,3909.8258114360297,5,5,4,14,0
12135,277,14,177.23639365334134,2,2,1,5,3
12136,271,7,3921.2546185547158,2,1,4,7,2
12137,14,17,3335.047157177288,5,2,4,11,1
12138,298,26,1214.7185052455252,1,3,2,6,3
12139,15,37,2628.451233938509,5,4,3,12,1
12140,234,20,255.96044655569818,2,2,1,5,3
12141,63,10,1904.147464993113,5,1,2,8,2
12142,196,19,878.471970594903,3,2,1,6,3
12143,27,18,121.27892624306338,5,2,1,8,2
12144,93,30,1791.8765938521697,4,3,2,9,2
12145,105,30,3633.3009627982337,4,3,4,11,1
12146,309,25,4605.8991181184365,1,3,5,9,2
12147,52,24,3314.6949303223423,5,3,4,12,1
12148,319,10,2015.8309393706484,1,1,3,5,3
12149,181,2,4997.485600885369,3,1,5,9,2
12150,57,38,1421.8881054200494,5,4,2,11,1
12151,120,32,943.7858492138209,4,4,1,9,2
12152,308,35,2323.774523437331,1,4,3,8,2
12153,363,37,2529.5079630546206,1,4,3,8,2
12154,43,7,1780.568666416198,5,1,2,8,2
12155,135,7,3480.540404436147,4,1,4,9,2
12156,260,27,927.4834155218034,2,3,1,6,3
12157,197,10,2556.5954011565223,3,1,3,7,2
12158,133,33,2505.6335229189335,4,4,3,11,1
12159,255,43,4120.69424918138,2,5,5,12,1
12160,220,7,4635.571311816416,2,1,5,8,2
12161,336,6,3319.6967098161913,1,1,4,6,3
12162,41,6,1533.8042357698591,5,1,2,8,2
12163,255,13,3451.158989142772,2,2,4,8,2
12164,2,48,1264.3419349100998,5,5,2,12,1
12165,195,13,4833.056508492892,3,2,5,10,1
12166,242,2,4113.586974222737,2,1,5,8,2
12167,149,19,2161.639374775529,3,2,3,8,2
12168,198,19,3923.874150536565,3,2,4,9,2
12169,299,38,2049.191670355922,1,4,3,8,2
12170,245,2,382.30469231094185,2,1,1,4,3
12171,338,26,3536.776676273021,1,3,4,8,2
12172,108,6,2029.0230268119185,4,1,3,8,2
12173,212,20,4652.29588575147,3,2,5,10,1
12174,156,23,1539.7404595031403,3,3,2,8,2
12175,26,15,4218.230779058421,5,2,5,12,1
12176,82,6,3405.3848475817535,4,1,4,9,2
12177,83,28,4268.089834478177,4,3,5,12,1
12178,131,35,1466.490566696842,4,4,2,10,1
12179,329,11,2312.1135625600346,1,2,3,6,3
12180,100,8,4117.413766064797,4,1,5,10,1
12181,256,49,3222.655907730822,2,5,4,11,1
12182,49,24,1806.0102784817195,5,3,2,10,1
12183,63,21,2564.858172289407,5,3,3,11,1
12184,311,49,4980.529490872746,1,5,5,11,1
12185,290,36,3711.8214971152706,2,4,4,10,1
12186,105,7,3076.468037372345,4,1,4,9,2
12187,105,5,4141.277788363243,4,1,5,10,1
12188,325,29,2215.731390473129,1,3,3,7,2
12189,15,16,4750.81938318696,5,2,5,12,1
12190,175,6,2764.5859311915037,3,1,3,7,2
12191,259,14,1641.0920266351798,2,2,2,6,3
12192,211,2,439.239688082445,3,1,1,5,3
12193,259,25,1884.7191440436452,2,3,2,7,2
12194,102,31,2847.5055014124864,4,4,3,11,1
12195,260,13,3519.208212278889,2,2,4,8,2
12196,344,18,4376.832297626256,1,2,5,8,2
12197,159,17,4720.364568265836,3,2,5,10,1
12198,45,45,521.2446924438275,5,5,1,11,1
12199,301,28,3008.515880129096,1,3,3,7,2
12200,251,12,3336.2823493234996,2,2,4,8,2
12201,331,35,868.5984467968605,1,4,1,6,3
12202,165,22,2732.547394514441,3,3,3,9,2
12203,193,39,1680.819841545573,3,4,2,9,2
12204,9,1,396.3124866097078,5,1,1,7,2
12205,65,37,338.6712959240396,5,4,1,10,1
12206,282,21,3798.4727724118184,2,3,4,9,2
12207,181,1,3081.1227048413875,3,1,4,8,2
12208,282,4,3578.457174369539,2,1,4,7,2
12209,279,32,3429.5379911366026,2,4,4,10,1
12210,30,1,680.2183758981415,5,1,1,7,2
12211,266,13,766.3106300534005,2,2,1,5,3
12212,328,46,1269.8937837935114,1,5,2,8,2
12213,217,47,2001.5119289538018,3,5,2,10,1
12214,320,17,4696.489362438783,1,2,5,8,2
12215,105,12,3372.7228833008926,4,2,4,10,1
12216,184,7,1283.3079529056727,3,1,2,6,3
12217,330,3,289.36066811842625,1,1,1,3,3
12218,148,26,3424.277414723802,3,3,4,10,1
12219,105,31,3130.3391693721,4,4,4,12,1
12220,47,36,3382.0594576270632,5,4,4,13,0
12221,87,26,1313.2864737523132,4,3,2,9,2
12222,309,3,2589.6464539545627,1,1,3,5,3
12223,129,44,1814.8969789435303,4,5,2,11,1
12224,258,28,4090.3177053392683,2,3,5,10,1
12225,314,44,356.28934397215284,1,5,1,7,2
12226,147,17,1384.454529313763,3,2,2,7,2
12227,72,38,3018.739183410142,5,4,3,12,1
12228,140,47,1034.0666475993673,4,5,2,11,1
12229,27,30,3366.840045504643,5,3,4,12,1
12230,29,2,692.4947909687635,5,1,1,7,2
12231,271,8,123.83333645476861,2,1,1,4,3
12232,174,14,4318.83771889715,3,2,5,10,1
12233,253,37,1673.8875630223285,2,4,2,8,2
12234,60,35,792.6764254745514,5,4,1,10,1
12235,107,42,871.8180384715412,4,5,1,10,1
12236,220,39,4430.618016232479,2,4,5,11,1
12237,259,11,3275.612716672593,2,2,4,8,2
12238,146,15,4782.167870284549,4,2,5,11,1
12239,52,2,4002.2012136557523,5,1,4,10,1
12240,60,37,3840.0379982905647,5,4,4,13,0
12241,34,43,2504.1050912796604,5,5,3,13,0
12242,96,32,4105.816444543666,4,4,5,13,0
12243,89,40,2069.13616682484,4,4,3,11,1
12244,316,13,4136.732480191448,1,2,5,8,2
12245,231,43,3791.1290455187427,2,5,4,11,1
12246,275,17,3395.408741724295,2,2,4,8,2
12247,246,15,1655.2837679576487,2,2,2,6,3
12248,111,33,3157.251070169715,4,4,4,12,1
12249,234,16,2538.8702476276453,2,2,3,7,2
12250,278,13,2313.0989059602894,2,2,3,7,2
12251,166,22,4951.329203583543,3,3,5,11,1
12252,128,23,2526.945170854046,4,3,3,10,1
12253,237,36,169.6111649642985,2,4,1,7,2
12254,291,43,3136.0746667186518,2,5,4,11,1
12255,107,10,3642.774116687913,4,1,4,9,2
12256,128,17,4427.067507890552,4,2,5,11,1
12257,195,30,3167.0967863469064,3,3,4,10,1
12258,339,13,107.09101482055914,1,2,1,4,3
12259,143,30,607.5242356978482,4,3,1,8,2
12260,111,46,814.5878452984884,4,5,1,10,1
12261,90,30,1064.1941516039499,4,3,2,9,2
12262,251,7,4000.8867168034653,2,1,4,7,2
12263,280,10,1555.7026495457658,2,1,2,5,3
12264,333,35,1568.6879906265945,1,4,2,7,2
12265,224,2,3780.3813304788637,2,1,4,7,2
12266,101,30,2068.058506861567,4,3,3,10,1
12267,132,19,332.551264449477,4,2,1,7,2
12268,13,39,2929.7809643455685,5,4,3,12,1
12269,98,37,659.0377556582038,4,4,1,9,2
12270,120,3,2862.6047570462038,4,1,3,8,2
12271,293,25,3900.3941570332827,1,3,4,8,2
12272,304,34,4648.153290263093,1,4,5,10,1
12273,199,22,344.59250867670085,3,3,1,7,2
12274,1,38,1526.7932529748282,5,4,2,11,1
12275,60,14,3265.795275209754,5,2,4,11,1
12276,250,39,1584.110484195498,2,4,2,8,2
12277,140,2,2260.6177998532626,4,1,3,8,2
12278,149,32,110.25340409603724,3,4,1,8,2
12279,44,43,3470.5550507475823,5,5,4,14,0
12280,186,3,4417.567856244944,3,1,5,9,2
12281,108,41,4884.5296425866445,4,5,5,14,0
12282,44,8,4154.361411289257,5,1,5,11,1
12283,78,26,168.56354949515227,4,3,1,8,2
12284,226,32,3262.7513012022796,2,4,4,10,1
12285,162,11,2483.3396391062106,3,2,3,8,2
12286,281,1,4690.0985111374375,2,1,5,8,2
12287,253,15,4511.6729348229865,2,2,5,9,2
12288,132,4,4940.350410167214,4,1,5,10,1
12289,144,4,4311.051779065797,4,1,5,10,1
12290,266,28,2738.9917479471815,2,3,3,8,2
12291,109,10,3577.353571896427,4,1,4,9,2
12292,194,11,4823.739409469034,3,2,5,10,1
12293,35,23,2894.8024715552965,5,3,3,11,1
12294,275,47,4201.496143191194,2,5,5,12,1
12295,187,3,4711.627281849079,3,1,5,9,2
12296,243,39,2856.983079331482,2,4,3,9,2
12297,264,39,804.1796879400829,2,4,1,7,2
12298,10,17,786.2613317696698,5,2,1,8,2
12299,166,22,585.4326990981195,3,3,1,7,2
12300,29,27,2386.852669571952,5,3,3,11,1
12301,271,16,2405.9064755810437,2,2,3,7,2
12302,87,16,3090.6822299723067,4,2,4,10,1
12303,23,40,2419.5353424625255,5,4,3,12,1
12304,210,3,4865.544527265284,3,1,5,9,2
12305,46,47,1463.6409947887753,5,5,2,12,1
12306,28,33,4370.344961467824,5,4,5,14,0
12307,26,42,510.6488338098015,5,5,1,11,1
12308,266,2,3013.5692134032856,2,1,3,6,3
12309,175,39,3245.1428346240723,3,4,4,11,1
12310,4,46,3863.42833161649,5,5,4,14,0
12311,311,48,2520.0808425965515,1,5,3,9,2
12312,322,27,994.1591722562597,1,3,1,5,3
12313,67,15,1851.2980866915655,5,2,2,9,2
12314,135,7,1368.08596731319,4,1,2,7,2
12315,55,45,2101.336523019659,5,5,3,13,0
12316,31,42,2654.541855486374,5,5,3,13,0
12317,74,9,3129.100753972474,4,1,4,9,2
12318,19,41,4227.158505134645,5,5,5,15,0
12319,156,6,4550.951502091175,3,1,5,9,2
12320,337,12,2318.2806116578254,1,2,3,6,3
12321,156,30,452.4704724077071,3,3,1,7,2
12322,147,20,3987.3552961125856,3,2,4,9,2
12323,87,20,2391.017048450546,4,2,3,9,2
12324,20,46,2736.7685408425928,5,5,3,13,0
12325,269,27,2983.0127584649626,2,3,3,8,2
12326,333,20,3342.6601161225312,1,2,4,7,2
12327,43,7,4451.603291562214,5,1,5,11,1
12328,306,40,4761.209514098853,1,4,5,10,1
12329,28,40,4701.444902100851,5,4,5,14,0
12330,260,30,4049.223624892342,2,3,5,10,1
12331,22,8,4447.318845383176,5,1,5,11,1
12332,101,2,257.77729705230627,4,1,1,6,3
12333,39,14,4247.072205608742,5,2,5,12,1
12334,290,10,370.6035319015824,2,1,1,4,3
12335,353,18,3733.50759885567,1,2,4,7,2
12336,300,18,855.1244717523874,1,2,1,4,3
12337,170,16,1806.951124601602,3,2,2,7,2
12338,296,5,929.0765589797631,1,1,1,3,3
12339,353,31,2222.8735668200143,1,4,3,8,2
12340,130,37,2064.619744644934,4,4,3,11,1
12341,156,20,249.83359142399183,3,2,1,6,3
12342,74,23,4154.184746062722,4,3,5,12,1
12343,342,32,4272.390614014182,1,4,5,10,1
12344,90,42,3939.661147584928,4,5,4,13,0
12345,67,17,4239.556950124032,5,2,5,12,1
12346,236,13,3756.8863862033504,2,2,4,8,2
12347,200,49,4688.047382411987,3,5,5,13,0
12348,332,13,2886.1973284970277,1,2,3,6,3
12349,227,17,2917.386307465069,2,2,3,7,2
12350,348,15,4300.9504430417055,1,2,5,8,2
12351,233,26,1753.5835781257979,2,3,2,7,2
12352,266,44,259.91094747082934,2,5,1,8,2
12353,86,28,3751.778423036832,4,3,4,11,1
12354,102,42,1280.4000052577096,4,5,2,11,1
12355,214,45,2376.4367020295017,3,5,3,11,1
12356,108,30,1209.794780015751,4,3,2,9,2
12357,165,43,4137.183351620711,3,5,5,13,0
12358,91,35,4791.88189574659,4,4,5,13,0
12359,192,22,284.56528696693323,3,3,1,7,2
12360,335,10,1174.524441003705,1,1,2,4,3
12361,86,11,955.9149978383975,4,2,1,7,2
12362,222,38,3369.285528579918,2,4,4,10,1
12363,363,33,2149.105214878957,1,4,3,8,2
12364,101,6,2286.745700935995,4,1,3,8,2
12365,226,37,793.8246310579117,2,4,1,7,2
12366,364,7,2079.5258612336797,1,1,3,5,3
12367,60,44,1523.1091203106785,5,5,2,12,1
12368,250,12,3059.842664206686,2,2,4,8,2
12369,48,7,1094.0187613964392,5,1,2,8,2
12370,117,2,3077.9085922189765,4,1,4,9,2
12371,227,1,1894.9485073760356,2,1,2,5,3
12372,362,23,1738.0098645216979,1,3,2,6,3
12373,33,25,1534.727604463458,5,3,2,10,1
12374,44,18,3372.4291351888915,5,2,4,11,1
12375,165,44,2816.4678431105494,3,5,3,11,1
12376,345,7,4260.091283010687,1,1,5,7,2
12377,292,3,1215.6347861011957,1,1,2,4,3
12378,337,29,210.1967012621153,1,3,1,5,3
12379,344,10,918.2971743711712,1,1,1,3,3
12380,287,43,1723.3482580010932,2,5,2,9,2
12381,364,5,906.4784016395079,1,1,1,3,3
12382,225,34,426.7182807567369,2,4,1,7,2
12383,286,8,2232.2389811161474,2,1,3,6,3
12384,204,14,3387.898982124672,3,2,4,9,2
12385,172,40,3760.3381271003477,3,4,4,11,1
12386,12,6,1999.6493503458314,5,1,2,8,2
12387,307,1,2395.442526789771,1,1,3,5,3
12388,121,33,3779.7977619402545,4,4,4,12,1
12389,244,40,1770.012073238642,2,4,2,8,2
12390,152,11,3925.9833942271835,3,2,4,9,2
12391,152,24,4837.20656733886,3,3,5,11,1
12392,188,10,4403.598310473489,3,1,5,9,2
12393,13,44,2273.440730068265,5,5,3,13,0
12394,91,23,2901.7972894957347,4,3,3,10,1
12395,200,16,3584.967669413772,3,2,4,9,2
12396,74,37,1753.0092077565419,4,4,2,10,1
12397,256,16,3998.1981188816667,2,2,4,8,2
12398,276,44,2190.2158064498494,2,5,3,10,1
12399,328,31,4235.739374921166,1,4,5,10,1
12400,329,6,1281.1221356810668,1,1,2,4,3
12401,71,30,66.77650110083312,5,3,1,9,2
12402,78,37,3167.1150959021516,4,4,4,12,1
12403,284,1,2264.9266962906972,2,1,3,6,3
12404,130,42,308.5173539176257,4,5,1,10,1
12405,43,25,2443.1856418346474,5,3,3,11,1
12406,8,46,851.1635286533592,5,5,1,11,1
12407,13,21,3152.448321778506,5,3,4,12,1
12408,213,35,2230.777432448174,3,4,3,10,1
12409,111,38,863.91251200571,4,4,1,9,2
12410,291,5,2065.5753465882945,2,1,3,6,3
12411,23,49,1171.216952805569,5,5,2,12,1
12412,302,12,3268.9529345598444,1,2,4,7,2
12413,254,5,1482.7654364881944,2,1,2,5,3
12414,15,9,4111.866576756002,5,1,5,11,1
12415,130,44,80.67439540264631,4,5,1,10,1
12416,61,9,2023.0557029460513,5,1,3,9,2
12417,115,35,3089.2314733839758,4,4,4,12,1
12418,320,1,122.81533940132319,1,1,1,3,3
12419,308,47,1087.0510935950329,1,5,2,8,2
12420,325,10,1643.8255980520048,1,1,2,4,3
12421,67,46,119.00432736589778,5,5,1,11,1
12422,249,39,2737.986617204846,2,4,3,9,2
12423,175,36,3158.03326153157,3,4,4,11,1
12424,339,37,1145.336036547034,1,4,2,7,2
12425,2,48,2721.9788093686084,5,5,3,13,0
12426,172,35,4995.643176895911,3,4,5,12,1
12427,334,17,4435.727245859125,1,2,5,8,2
12428,284,13,302.71754968644433,2,2,1,5,3
12429,54,6,648.1334974374629,5,1,1,7,2
12430,67,37,2477.0725735331425,5,4,3,12,1
12431,102,48,1233.5535631749276,4,5,2,11,1
12432,120,32,414.03649351238624,4,4,1,9,2
12433,191,11,1280.2269188011371,3,2,2,7,2
12434,304,17,315.2787073922748,1,2,1,4,3
12435,47,5,2654.2630861570883,5,1,3,9,2
12436,222,6,2456.348017316471,2,1,3,6,3
12437,21,10,41.567506245189406,5,1,1,7,2
12438,158,33,2417.7568142632067,3,4,3,10,1
12439,348,30,2603.827684832345,1,3,3,7,2
12440,159,21,3032.461667647878,3,3,3,9,2
12441,235,42,4850.797624788457,2,5,5,12,1
12442,150,17,4913.635210989482,3,2,5,10,1
12443,257,27,2639.377260247403,2,3,3,8,2
12444,165,3,4227.481621072815,3,1,5,9,2
12445,77,29,434.97719225164303,4,3,1,8,2
12446,85,2,2660.461565926076,4,1,3,8,2
12447,46,29,3397.711295527569,5,3,4,12,1
12448,47,49,2827.996809652046,5,5,3,13,0
12449,213,36,1161.2977623263832,3,4,2,9,2
12450,59,34,322.66335166000863,5,4,1,10,1
12451,54,37,1939.479730030196,5,4,2,11,1
12452,342,42,3241.736063955926,1,5,4,10,1
12453,12,1,4958.648237541254,5,1,5,11,1
12454,192,26,1190.3019224058917,3,3,2,8,2
12455,6,1,4589.771649459805,5,1,5,11,1
12456,309,4,350.62438363106736,1,1,1,3,3
12457,144,39,4655.636476880652,4,4,5,13,0
12458,346,14,4163.51017167145,1,2,5,8,2
12459,261,46,114.51731013192123,2,5,1,8,2
12460,73,18,1497.9450167024365,5,2,2,9,2
12461,174,34,264.2737018558823,3,4,1,8,2
12462,232,1,4977.574298932502,2,1,5,8,2
12463,270,22,2144.9415828730434,2,3,3,8,2
12464,362,16,3314.2458628570807,1,2,4,7,2
12465,222,22,1178.61096836371,2,3,2,7,2
12466,52,16,4669.343830951083,5,2,5,12,1
12467,116,28,1378.1287018119635,4,3,2,9,2
12468,26,28,1308.4708904384695,5,3,2,10,1
12469,53,22,1579.8544787473506,5,3,2,10,1
12470,29,6,2317.820931607025,5,1,3,9,2
12471,19,25,102.47830388625803,5,3,1,9,2
12472,303,42,2993.2091256391413,1,5,3,9,2
12473,279,2,168.01232773228332,2,1,1,4,3
12474,117,7,2700.62041382057,4,1,3,8,2
12475,106,17,2294.845661888739,4,2,3,9,2
12476,309,35,1220.309820100687,1,4,2,7,2
12477,227,20,1655.5424056824254,2,2,2,6,3
12478,352,44,3531.2424581109017,1,5,4,10,1
12479,186,2,57.89162415826775,3,1,1,5,3
12480,261,7,1590.069218748541,2,1,2,5,3
12481,16,32,3404.6832982826877,5,4,4,13,0
12482,273,49,769.8465883587248,2,5,1,8,2
12483,160,19,2806.3244143886554,3,2,3,8,2
12484,358,12,852.9753131287363,1,2,1,4,3
12485,250,9,782.261765516428,2,1,1,4,3
12486,224,27,3863.677677661547,2,3,4,9,2
12487,256,14,1339.9615129726772,2,2,2,6,3
12488,180,2,1885.0879035731118,3,1,2,6,3
12489,20,21,3652.7901474685996,5,3,4,12,1
12490,112,4,905.8028067094519,4,1,1,6,3
12491,120,21,2663.3677364509595,4,3,3,10,1
12492,194,48,4589.920122185668,3,5,5,13,0
12493,111,22,2773.5958286986584,4,3,3,10,1
12494,210,49,253.74037545091286,3,5,1,9,2
12495,1,2,2952.589400638782,5,1,3,9,2
12496,58,17,459.8654635768452,5,2,1,8,2
12497,93,19,1417.8014567620824,4,2,2,8,2
12498,221,40,4249.878775664122,2,4,5,11,1
12499,211,24,65.23494906240346,3,3,1,7,2
12500,232,20,394.29641023646195,2,2,1,5,3
12501,262,38,1823.187002115051,2,4,2,8,2
12502,364,12,4996.985440697754,1,2,5,8,2
12503,103,25,1466.4008912984975,4,3,2,9,2
12504,50,23,794.8003474927957,5,3,1,9,2
12505,110,34,2751.616442912762,4,4,3,11,1
12506,88,32,2601.0825576363127,4,4,3,11,1
12507,20,24,2253.6017462598993,5,3,3,11,1
12508,14,42,4733.802222694314,5,5,5,15,0
12509,133,25,1407.9453610430885,4,3,2,9,2
12510,296,3,1473.6879040172114,1,1,2,4,3
12511,34,25,709.8822872215499,5,3,1,9,2
12512,208,28,3489.467209401715,3,3,4,10,1
12513,301,12,1613.633660691886,1,2,2,5,3
12514,199,26,4015.674062297806,3,3,5,11,1
12515,80,48,4859.071808090872,4,5,5,14,0
12516,71,44,227.989357533054,5,5,1,11,1
12517,155,8,4965.678231390043,3,1,5,9,2
12518,78,5,1277.9800895218511,4,1,2,7,2
12519,78,11,2106.3506827000924,4,2,3,9,2
12520,172,42,3890.939338918534,3,5,4,12,1
12521,289,35,3330.002399275229,2,4,4,10,1
12522,33,27,3894.400234966018,5,3,4,12,1
12523,300,41,2336.996758437105,1,5,3,9,2
12524,276,44,4581.174722078589,2,5,5,12,1
12525,7,38,3951.8046189715,5,4,4,13,0
12526,160,19,1553.0475974140436,3,2,2,7,2
12527,240,48,4742.916304530312,2,5,5,12,1
12528,24,32,4805.660425197508,5,4,5,14,0
12529,214,46,2081.1172432261533,3,5,3,11,1
12530,70,28,3263.2828350580776,5,3,4,12,1
12531,216,36,4075.6949907173785,3,4,5,12,1
12532,104,18,4088.3305771885216,4,2,5,11,1
12533,215,10,80.47648800687935,3,1,1,5,3
12534,54,32,3148.7780289022417,5,4,4,13,0
12535,294,18,4868.7594942785245,1,2,5,8,2
12536,330,12,1164.422267502894,1,2,2,5,3
12537,336,8,3980.0882072929235,1,1,4,6,3
12538,203,33,2675.8956291741424,3,4,3,10,1
12539,288,46,1115.1363535831686,2,5,2,9,2
12540,45,38,264.67949067914014,5,4,1,10,1
12541,317,14,3802.0093379748682,1,2,4,7,2
12542,198,2,1589.1870441288868,3,1,2,6,3
12543,216,9,1884.1742800448721,3,1,2,6,3
12544,309,44,2431.302955712565,1,5,3,9,2
12545,332,5,2540.902565826828,1,1,3,5,3
12546,184,34,1038.8660290823511,3,4,2,9,2
12547,27,19,3356.50353104047,5,2,4,11,1
12548,166,7,3465.774499979809,3,1,4,8,2
12549,318,39,720.0816132512249,1,4,1,6,3
12550,274,42,2669.2186041637806,2,5,3,10,1
12551,103,17,3050.2041476541926,4,2,4,10,1
12552,333,26,939.3952015674589,1,3,1,5,3
12553,104,46,4473.366011381281,4,5,5,14,0
12554,245,27,2419.301047264689,2,3,3,8,2
12555,305,43,583.9915047534256,1,5,1,7,2
12556,169,28,1678.636926329762,3,3,2,8,2
12557,116,20,2390.032636890523,4,2,3,9,2
12558,141,6,60.61932387271263,4,1,1,6,3
12559,356,8,169.23027973039552,1,1,1,3,3
12560,125,32,287.04777059998344,4,4,1,9,2
12561,25,19,2695.294777238172,5,2,3,10,1
12562,194,32,1687.0800992252307,3,4,2,9,2
12563,100,19,4466.589199799438,4,2,5,11,1
12564,5,24,2800.5770229211826,5,3,3,11,1
12565,19,24,3801.8826808163462,5,3,4,12,1
12566,170,17,3438.794552007811,3,2,4,9,2
12567,274,18,2606.4004289162503,2,2,3,7,2
12568,254,12,3726.1549944279723,2,2,4,8,2
12569,121,41,2728.0814573099674,4,5,3,12,1
12570,32,23,1933.426962900348,5,3,2,10,1
12571,149,48,2184.666114213165,3,5,3,11,1
12572,266,18,4194.121684323968,2,2,5,9,2
12573,37,16,2820.7350550364986,5,2,3,10,1
12574,177,16,1892.707779329955,3,2,2,7,2
12575,342,36,906.918326415378,1,4,1,6,3
12576,13,23,2481.8356325865093,5,3,3,11,1
12577,183,22,1269.4965065670488,3,3,2,8,2
12578,145,39,4778.343591860567,4,4,5,13,0
12579,265,33,2460.00060240893,2,4,3,9,2
12580,88,24,54.651886707393025,4,3,1,8,2
12581,46,20,473.4571755774263,5,2,1,8,2
12582,119,33,1428.7792136356072,4,4,2,10,1
12583,19,31,469.892580074572,5,4,1,10,1
12584,220,40,4470.871505222053,2,4,5,11,1
12585,233,8,4273.214318334649,2,1,5,8,2
12586,94,10,4854.598929295016,4,1,5,10,1
12587,251,1,3535.263415575611,2,1,4,7,2
12588,250,21,3230.868085597959,2,3,4,9,2
12589,282,25,4618.248223099926,2,3,5,10,1
12590,232,32,4732.501792583558,2,4,5,11,1
12591,46,46,4388.664335989177,5,5,5,15,0
12592,46,46,4308.749490660915,5,5,5,15,0
12593,14,10,3361.799244664203,5,1,4,10,1
12594,85,48,18.013676725827555,4,5,1,10,1
12595,319,9,2153.290081144967,1,1,3,5,3
12596,328,20,3181.957228184944,1,2,4,7,2
12597,3,48,2740.165628418578,5,5,3,13,0
12598,28,20,4107.4218831554535,5,2,5,12,1
12599,157,40,4096.322359805508,3,4,5,12,1
12600,343,7,2997.4232272134122,1,1,3,5,3
12601,333,11,119.75032576272773,1,2,1,4,3
12602,332,21,1852.9564621502416,1,3,2,6,3
12603,175,38,1151.794760863935,3,4,2,9,2
12604,114,47,1700.5526626887015,4,5,2,11,1
12605,331,19,3090.2903460351486,1,2,4,7,2
12606,250,46,341.6448943868105,2,5,1,8,2
12607,59,15,120.98782475436796,5,2,1,8,2
12608,203,6,2189.995850741719,3,1,3,7,2
12609,315,10,3969.933422915748,1,1,4,6,3
12610,239,46,163.18588724677375,2,5,1,8,2
12611,234,16,4246.752439614388,2,2,5,9,2
12612,303,45,1925.5593674225395,1,5,2,8,2
12613,95,11,599.9947904378045,4,2,1,7,2
12614,141,35,2841.8136667025296,4,4,3,11,1
12615,334,8,4762.279201507802,1,1,5,7,2
12616,113,28,2717.139366203687,4,3,3,10,1
12617,109,3,3436.3074313719976,4,1,4,9,2
12618,362,2,4083.942221586189,1,1,5,7,2
12619,345,14,3998.7072100146247,1,2,4,7,2
12620,289,29,374.862455283561,2,3,1,6,3
12621,97,47,3707.567112022315,4,5,4,13,0
12622,335,3,4747.753333705645,1,1,5,7,2
12623,16,1,3506.2546475630807,5,1,4,10,1
12624,44,15,4183.850039615234,5,2,5,12,1
12625,230,20,2432.8930080454875,2,2,3,7,2
12626,108,22,1602.1559386006286,4,3,2,9,2
12627,217,34,3384.4337232234607,3,4,4,11,1
12628,260,33,2466.077890815882,2,4,3,9,2
12629,312,9,4477.4913930088815,1,1,5,7,2
12630,320,3,4872.166023283358,1,1,5,7,2
12631,196,2,4100.812316869913,3,1,5,9,2
12632,95,4,4963.4712912523655,4,1,5,10,1
12633,56,16,1748.3692859875728,5,2,2,9,2
12634,32,33,4479.819339984872,5,4,5,14,0
12635,231,9,1656.3688076989238,2,1,2,5,3
12636,9,40,599.0099957767083,5,4,1,10,1
12637,191,38,3110.654739604129,3,4,4,11,1
12638,361,18,2280.393285216862,1,2,3,6,3
12639,200,16,4609.279174818783,3,2,5,10,1
12640,334,8,2466.047499014295,1,1,3,5,3
12641,161,23,4638.8865707783725,3,3,5,11,1
12642,87,36,402.3829973035618,4,4,1,9,2
12643,21,3,4154.25406037421,5,1,5,11,1
12644,311,15,3797.980199637268,1,2,4,7,2
12645,76,38,3602.691584657926,4,4,4,12,1
12646,141,33,1782.127916793261,4,4,2,10,1
12647,126,18,3920.9605836278965,4,2,4,10,1
12648,251,23,2421.649930431437,2,3,3,8,2
12649,84,43,3578.8655193149925,4,5,4,13,0
12650,48,3,2765.613462,5,1,3,9,2
12651,78,30,795.6241256217212,4,3,1,8,2
12652,30,45,332.14736496477815,5,5,1,11,1
12653,285,17,1837.2713895049849,2,2,2,6,3
12654,136,32,4664.616226499784,4,4,5,13,0
12655,140,46,2653.37775389955,4,5,3,12,1
12656,41,7,4012.9384174081856,5,1,4,10,1
12657,282,39,2884.005822537669,2,4,3,9,2
12658,50,14,4789.947378504454,5,2,5,12,1
12659,258,15,1853.5832551514582,2,2,2,6,3
12660,311,44,294.6817723360849,1,5,1,7,2
12661,360,12,3905.5352326948673,1,2,4,7,2
12662,270,8,3530.227976572146,2,1,4,7,2
12663,134,16,2642.3965673693474,4,2,3,9,2
12664,234,41,1638.69230351967,2,5,2,9,2
12665,128,34,949.4430869703018,4,4,1,9,2
12666,104,46,2416.5574604398084,4,5,3,12,1
12667,254,24,3334.3450323595293,2,3,4,9,2
12668,95,29,2898.6432825572624,4,3,3,10,1
12669,337,16,2193.077646754324,1,2,3,6,3
12670,217,5,2703.075277202683,3,1,3,7,2
12671,61,5,548.6951022698463,5,1,1,7,2
12672,268,30,3482.2421182610074,2,3,4,9,2
12673,241,5,3673.937658541708,2,1,4,7,2
12674,13,43,67.14849444448205,5,5,1,11,1
12675,147,13,1359.8925837457361,3,2,2,7,2
12676,240,35,469.6631322646324,2,4,1,7,2
12677,89,49,4991.178338053739,4,5,5,14,0
12678,95,25,2970.780740438265,4,3,3,10,1
12679,315,14,2334.0330901905463,1,2,3,6,3
12680,293,44,2320.3750847154756,1,5,3,9,2
12681,25,46,4824.2218569515635,5,5,5,15,0
12682,272,26,3302.6796343662463,2,3,4,9,2
12683,166,18,851.611195652978,3,2,1,6,3
12684,250,20,2246.312551699378,2,2,3,7,2
12685,87,34,3873.242236320037,4,4,4,12,1
12686,142,7,2122.5168336253773,4,1,3,8,2
12687,134,47,1554.5717951754245,4,5,2,11,1
12688,279,10,4956.168222135474,2,1,5,8,2
12689,126,15,4678.829301715023,4,2,5,11,1
12690,316,17,4708.386242926554,1,2,5,8,2
12691,141,11,667.045923066961,4,2,1,7,2
12692,356,34,1178.9337314777185,1,4,2,7,2
12693,103,27,2215.9141212475465,4,3,3,10,1
12694,226,21,4162.324998580466,2,3,5,10,1
12695,63,31,3686.7694257358394,5,4,4,13,0
12696,294,4,4249.840301810622,1,1,5,7,2
12697,306,41,4604.608822875281,1,5,5,11,1
12698,254,49,3906.0265468220955,2,5,4,11,1
12699,180,17,1316.2323506234416,3,2,2,7,2
12700,40,49,1434.3739551119747,5,5,2,12,1
12701,264,48,1768.913531299261,2,5,2,9,2
12702,189,20,1522.3460804997517,3,2,2,7,2
12703,8,25,1253.0037590185343,5,3,2,10,1
12704,104,40,3764.905438779954,4,4,4,12,1
12705,225,23,179.61534399290238,2,3,1,6,3
12706,34,15,3644.6847530943746,5,2,4,11,1
12707,236,33,4119.58321985969,2,4,5,11,1
12708,228,19,339.559776290641,2,2,1,5,3
12709,188,15,318.61706493297095,3,2,1,6,3
12710,313,41,1434.464376437572,1,5,2,8,2
12711,22,5,1049.4510098523094,5,1,2,8,2
12712,343,16,2909.8570317140648,1,2,3,6,3
12713,40,45,3380.503202073152,5,5,4,14,0
12714,173,48,3174.3685605605806,3,5,4,12,1
12715,179,32,1793.1633776084914,3,4,2,9,2
12716,86,22,2497.0051947220445,4,3,3,10,1
12717,133,43,3203.5542392255534,4,5,4,13,0
12718,351,32,605.9370813437878,1,4,1,6,3
12719,13,13,1155.2644531249314,5,2,2,9,2
12720,28,38,4453.575808391052,5,4,5,14,0
12721,84,26,1718.20861898008,4,3,2,9,2
12722,318,17,4007.7703457793295,1,2,4,7,2
12723,349,5,1262.4388641623489,1,1,2,4,3
12724,343,49,217.78535416474907,1,5,1,7,2
12725,280,33,2506.998956442314,2,4,3,9,2
12726,354,27,4463.485397376807,1,3,5,9,2
12727,263,5,4098.229900219268,2,1,5,8,2
12728,166,37,1272.1664529332045,3,4,2,9,2
12729,293,7,4550.579514377491,1,1,5,7,2
12730,68,48,2403.782315632353,5,5,3,13,0
12731,226,18,254.5050289054636,2,2,1,5,3
12732,170,31,149.34385264108116,3,4,1,8,2
12733,86,6,2430.717532676592,4,1,3,8,2
12734,133,2,2736.151050011943,4,1,3,8,2
12735,178,13,408.7654737071259,3,2,1,6,3
12736,343,42,4611.980862088643,1,5,5,11,1
12737,252,11,3593.901974169207,2,2,4,8,2
12738,15,26,4008.3989688488414,5,3,4,12,1
12739,223,21,2924.276023569594,2,3,3,8,2
12740,201,2,3321.084940011028,3,1,4,8,2
12741,107,40,1945.4225468373304,4,4,2,10,1
12742,250,20,3399.6924538710255,2,2,4,8,2
12743,89,17,4891.132628107304,4,2,5,11,1
12744,125,16,3242.102393948735,4,2,4,10,1
12745,113,42,1714.752277137117,4,5,2,11,1
12746,137,5,1433.3432206885145,4,1,2,7,2
12747,247,14,4817.096244826845,2,2,5,9,2
12748,166,24,933.1614625692446,3,3,1,7,2
12749,150,4,4032.921092231403,3,1,5,9,2
12750,363,48,2331.6588371237062,1,5,3,9,2
12751,343,24,2224.361174220475,1,3,3,7,2
12752,68,47,3740.2135620144563,5,5,4,14,0
12753,221,9,748.7117659292576,2,1,1,4,3
12754,271,3,2336.816671463153,2,1,3,6,3
12755,321,9,188.81010196106408,1,1,1,3,3
12756,310,18,3355.330039342232,1,2,4,7,2
12757,349,36,301.3026469287952,1,4,1,6,3
12758,20,19,445.571100392696,5,2,1,8,2
12759,289,24,4225.683642333724,2,3,5,10,1
12760,100,4,2220.3463832094803,4,1,3,8,2
12761,252,9,1012.8686858557303,2,1,1,4,3
12762,77,33,2966.9970340173454,4,4,3,11,1
12763,135,1,2601.223490276812,4,1,3,8,2
12764,173,35,2060.432550446862,3,4,3,10,1
12765,363,10,4528.031163079244,1,1,5,7,2
12766,201,12,3749.7954107802066,3,2,4,9,2
12767,217,18,766.4484275639302,3,2,1,6,3
12768,208,14,2858.165503237625,3,2,3,8,2
12769,74,10,452.8320645167879,4,1,1,6,3
12770,11,10,1230.8233125096049,5,1,2,8,2
12771,287,18,4550.203130135996,2,2,5,9,2
12772,256,24,2315.7788292841287,2,3,3,8,2
12773,12,1,4461.609447072331,5,1,5,11,1
12774,78,30,838.334838301905,4,3,1,8,2
12775,172,15,1034.655320083078,3,2,2,7,2
12776,96,8,1770.595368104793,4,1,2,7,2
12777,306,35,1837.964954874739,1,4,2,7,2
12778,273,18,3728.9335784508153,2,2,4,8,2
12779,179,41,3001.058704222176,3,5,3,11,1
12780,64,16,2770.714635473684,5,2,3,10,1
12781,132,21,3015.853779072189,4,3,3,10,1
12782,343,15,3663.6349488918113,1,2,4,7,2
12783,272,5,4465.155026659353,2,1,5,8,2
12784,319,45,2079.5523828213286,1,5,3,9,2
12785,332,7,4016.6004551880924,1,1,5,7,2
12786,341,48,2480.533446599283,1,5,3,9,2
12787,109,7,3613.1704303221964,4,1,4,9,2
12788,273,27,4375.37070241824,2,3,5,10,1
12789,168,25,170.7519636005204,3,3,1,7,2
12790,180,22,2737.682479130535,3,3,3,9,2
12791,58,48,4947.009326037773,5,5,5,15,0
12792,79,13,2486.159828467096,4,2,3,9,2
12793,61,17,4322.875376182445,5,2,5,12,1
12794,121,41,937.6402635599786,4,5,1,10,1
12795,207,44,3025.392580329195,3,5,3,11,1
12796,34,13,4352.826756539882,5,2,5,12,1
12797,70,26,2163.350326777668,5,3,3,11,1
12798,17,9,2438.743073936168,5,1,3,9,2
12799,20,5,419.2693432005988,5,1,1,7,2
12800,315,39,220.43873883351898,1,4,1,6,3
12801,69,33,2348.854414919086,5,4,3,12,1
12802,215,4,4218.941904889258,3,1,5,9,2
12803,161,28,4657.308117852427,3,3,5,11,1
12804,102,26,3296.6784872717653,4,3,4,11,1
12805,206,4,4133.729010679741,3,1,5,9,2
12806,145,16,3676.9222716654426,4,2,4,10,1
12807,57,37,3510.414276233043,5,4,4,13,0
12808,83,22,3847.475162945926,4,3,4,11,1
12809,269,36,2531.4617325305367,2,4,3,9,2
12810,187,38,2295.111136449304,3,4,3,10,1
12811,6,35,804.126175986882,5,4,1,10,1
12812,353,25,4220.6384303733685,1,3,5,9,2
12813,350,8,232.62326171848423,1,1,1,3,3
12814,110,17,1344.5461649742722,4,2,2,8,2
12815,138,18,2604.3815742571883,4,2,3,9,2
12816,51,12,4858.274581485028,5,2,5,12,1
12817,51,33,3932.004982056527,5,4,4,13,0
12818,87,23,1849.6694109966538,4,3,2,9,2
12819,68,12,3572.602468657051,5,2,4,11,1
12820,84,11,4657.533246195629,4,2,5,11,1
12821,42,13,2699.028423170009,5,2,3,10,1
12822,219,35,2315.0815755497374,2,4,3,9,2
12823,57,27,2769.436428648894,5,3,3,11,1
12824,226,25,1564.5349053583739,2,3,2,7,2
12825,196,40,4537.670565314111,3,4,5,12,1
12826,248,3,3988.43624418277,2,1,4,7,2
12827,166,49,3530.3657206428525,3,5,4,12,1
12828,62,25,2949.569482007587,5,3,3,11,1
12829,263,45,4847.679144476419,2,5,5,12,1
12830,112,10,1495.551590077358,4,1,2,7,2
12831,253,17,1422.8444728851791,2,2,2,6,3
12832,199,3,1218.2702809872792,3,1,2,6,3
12833,178,45,3711.462183338213,3,5,4,12,1
12834,26,22,3988.455342972758,5,3,4,12,1
12835,246,38,2989.5997390717926,2,4,3,9,2
12836,19,14,3263.398714587205,5,2,4,11,1
12837,265,27,1751.3142153859,2,3,2,7,2
12838,317,42,208.3901369396828,1,5,1,7,2
12839,20,20,1275.6428597698525,5,2,2,9,2
12840,106,48,2925.6731033808255,4,5,3,12,1
12841,237,18,4066.5340850980992,2,2,5,9,2
12842,306,13,3888.202942380656,1,2,4,7,2
12843,246,42,905.6419473239744,2,5,1,8,2
12844,81,6,266.7165882803792,4,1,1,6,3
12845,150,10,4254.2945995802465,3,1,5,9,2
12846,10,37,387.19027118623154,5,4,1,10,1
12847,321,29,1972.6232013174417,1,3,2,6,3
12848,224,6,480.18602735672926,2,1,1,4,3
12849,264,39,2824.6030651385477,2,4,3,9,2
12850,149,11,1823.0487916257061,3,2,2,7,2
12851,278,48,1020.4431528295476,2,5,1,8,2
12852,274,25,2979.886664408026,2,3,3,8,2
12853,194,44,1823.325031499651,3,5,2,10,1
12854,172,44,842.2733760867993,3,5,1,9,2
12855,265,30,3503.4311986956723,2,3,4,9,2
12856,310,20,4185.673466313058,1,2,5,8,2
12857,26,37,1375.9754297266006,5,4,2,11,1
12858,350,16,940.2609785511829,1,2,1,4,3
12859,356,31,385.5067913075455,1,4,1,6,3
12860,26,29,2644.2316041003305,5,3,3,11,1
12861,34,6,4158.155561735879,5,1,5,11,1
12862,264,29,1261.4415760516017,2,3,2,7,2
12863,138,32,2308.5824804358317,4,4,3,11,1
12864,304,9,812.4092327044212,1,1,1,3,3
12865,183,37,2026.962111728202,3,4,3,10,1
12866,363,23,87.07108670182143,1,3,1,5,3
12867,242,16,4554.538048588729,2,2,5,9,2
12868,54,18,3386.0937560528378,5,2,4,11,1
12869,168,19,1670.740450997511,3,2,2,7,2
12870,119,44,4407.179317679555,4,5,5,14,0
12871,143,2,922.8188508708909,4,1,1,6,3
12872,81,10,402.88132195981495,4,1,1,6,3
12873,245,12,4713.681689918003,2,2,5,9,2
12874,352,46,1551.9946390621099,1,5,2,8,2
12875,358,18,4680.507236601184,1,2,5,8,2
12876,62,19,3191.6884671713055,5,2,4,11,1
12877,46,38,4900.4142347492025,5,4,5,14,0
12878,87,37,3769.611768939978,4,4,4,12,1
12879,99,27,536.3644959722071,4,3,1,8,2
12880,295,48,4262.621048207657,1,5,5,11,1
12881,53,14,747.9138274145618,5,2,1,8,2
12882,192,45,3464.066052813827,3,5,4,12,1
12883,80,34,2507.0331726225877,4,4,3,11,1
12884,16,2,3541.5477906409747,5,1,4,10,1
12885,360,44,3827.29776801431,1,5,4,10,1
12886,326,33,4020.2894049524475,1,4,5,10,1
12887,194,19,4176.550862151618,3,2,5,10,1
12888,141,27,4237.650362532722,4,3,5,12,1
12889,108,48,2068.7463883468745,4,5,3,12,1
12890,303,30,4447.248080239116,1,3,5,9,2
12891,265,7,3600.7054651924773,2,1,4,7,2
12892,290,27,4196.464947777431,2,3,5,10,1
12893,209,21,4946.064850794354,3,3,5,11,1
12894,165,7,590.9095632414288,3,1,1,5,3
12895,342,48,1859.1926914501864,1,5,2,8,2
12896,320,25,4034.669633324263,1,3,5,9,2
12897,152,38,440.6543222673271,3,4,1,8,2
12898,290,18,2708.4975167075763,2,2,3,7,2
12899,268,33,4293.405815051372,2,4,5,11,1
12900,151,33,104.76640340874734,3,4,1,8,2
12901,207,32,4698.199303809772,3,4,5,12,1
12902,255,25,4890.942671283968,2,3,5,10,1
12903,353,14,1618.181839244108,1,2,2,5,3
12904,141,38,3836.288045036355,4,4,4,12,1
12905,343,38,644.6087522956127,1,4,1,6,3
12906,358,4,3866.5927099306027,1,1,4,6,3
12907,96,44,2412.793187361686,4,5,3,12,1
12908,227,18,4302.762661855779,2,2,5,9,2
12909,193,10,1070.9060721082421,3,1,2,6,3
12910,303,35,3366.563186678775,1,4,4,9,2
12911,314,35,3932.7346803350947,1,4,4,9,2
12912,118,40,1020.436403609115,4,4,1,9,2
12913,5,23,4093.253515073409,5,3,5,13,0
12914,352,25,4790.347649699927,1,3,5,9,2
12915,243,1,3084.2322136039484,2,1,4,7,2
12916,21,18,3926.403579784847,5,2,4,11,1
12917,152,15,2667.593458204632,3,2,3,8,2
12918,128,25,2994.5357713681974,4,3,3,10,1
12919,124,32,76.62864828313944,4,4,1,9,2
12920,146,20,2626.1934615117752,4,2,3,9,2
12921,277,17,2882.06311162196,2,2,3,7,2
12922,310,11,3353.5372533692785,1,2,4,7,2
12923,152,13,855.2591380751163,3,2,1,6,3
12924,360,25,1214.4575693016118,1,3,2,6,3
12925,111,20,3782.463112144391,4,2,4,10,1
12926,116,25,846.5177119365545,4,3,1,8,2
12927,188,42,2085.9701012049277,3,5,3,11,1
12928,57,45,1259.9461927545888,5,5,2,12,1
12929,251,49,2730.468677072549,2,5,3,10,1
12930,150,31,4934.485696963169,3,4,5,12,1
12931,162,1,4261.669109414684,3,1,5,9,2
12932,120,16,1354.6769564083345,4,2,2,8,2
12933,70,48,1849.3729347864287,5,5,2,12,1
12934,351,28,4593.981576664219,1,3,5,9,2
12935,99,21,4492.491912050145,4,3,5,12,1
12936,167,30,811.0349118587798,3,3,1,7,2
12937,298,3,4148.062947455122,1,1,5,7,2
12938,151,34,1495.0634448893845,3,4,2,9,2
12939,326,6,2723.5777649981646,1,1,3,5,3
12940,2,43,35.44096255808864,5,5,1,11,1
12941,152,29,4992.965052571813,3,3,5,11,1
12942,65,3,3807.8713835457584,5,1,4,10,1
12943,326,33,1216.2479688946353,1,4,2,7,2
12944,69,11,3422.136521753911,5,2,4,11,1
12945,121,45,1473.6037404891647,4,5,2,11,1
12946,109,5,456.3845117902225,4,1,1,6,3
12947,316,32,2132.2966822719804,1,4,3,8,2
12948,247,47,3072.457123593789,2,5,4,11,1
12949,93,18,457.98951647328073,4,2,1,7,2
12950,268,47,2596.847429659424,2,5,3,10,1
12951,103,20,2579.172519903095,4,2,3,9,2
12952,112,39,3146.939750662378,4,4,4,12,1
12953,321,49,1230.781736267014,1,5,2,8,2
12954,304,40,113.00100139687305,1,4,1,6,3
12955,344,28,1631.0389585607688,1,3,2,6,3
12956,62,13,1998.920150703227,5,2,2,9,2
12957,300,26,3182.347862855329,1,3,4,8,2
12958,136,16,4651.557592753505,4,2,5,11,1
12959,55,25,1024.8937586897541,5,3,2,10,1
12960,108,10,3439.794807554016,4,1,4,9,2
12961,303,29,496.0305377726165,1,3,1,5,3
12962,258,46,961.2025602185372,2,5,1,8,2
12963,253,38,2550.581212732262,2,4,3,9,2
12964,222,20,3544.8041200072657,2,2,4,8,2
12965,167,26,4294.2569943452845,3,3,5,11,1
12966,160,32,3722.078125578694,3,4,4,11,1
12967,166,39,86.61040643398647,3,4,1,8,2
12968,205,38,3422.8173163375923,3,4,4,11,1
12969,267,49,4125.04194146453,2,5,5,12,1
12970,138,24,2632.4120521717987,4,3,3,10,1
12971,346,31,4828.3374679223825,1,4,5,10,1
12972,248,40,31.518987994727265,2,4,1,7,2
12973,55,12,4095.1031736152763,5,2,5,12,1
12974,209,36,1680.7504622767804,3,4,2,9,2
12975,17,10,3255.7444108717586,5,1,4,10,1
12976,68,6,3470.474653148314,5,1,4,10,1
12977,133,7,1538.1825917225374,4,1,2,7,2
12978,188,31,4977.168254069404,3,4,5,12,1
12979,308,27,525.2176400711622,1,3,1,5,3
12980,138,8,793.5751349915801,4,1,1,6,3
12981,174,3,4462.0366092028,3,1,5,9,2
12982,97,40,604.7075834599104,4,4,1,9,2
12983,171,47,1912.6184610823834,3,5,2,10,1
12984,154,21,3668.3796373620453,3,3,4,10,1
12985,183,1,3959.5443855703343,3,1,4,8,2
12986,242,45,4773.7991922958345,2,5,5,12,1
12987,304,15,3949.9734350242584,1,2,4,7,2
12988,285,7,4224.216596757589,2,1,5,8,2
12989,27,15,4747.386268415109,5,2,5,12,1
12990,360,25,2772.90158444783,1,3,3,7,2
12991,60,3,1723.7329658917363,5,1,2,8,2
12992,202,30,3810.4495918858506,3,3,4,10,1
12993,250,14,826.0725162435679,2,2,1,5,3
12994,362,4,350.4760333202425,1,1,1,3,3
12995,69,36,3928.8010169626177,5,4,4,13,0
12996,21,3,4753.85007673363,5,1,5,11,1
12997,152,5,2217.810255382213,3,1,3,7,2
12998,102,25,814.0559327061112,4,3,1,8,2
12999,95,31,2490.1346706734444,4,4,3,11,1
13000,361,11,1972.656081247523,1,2,2,5,3
13001,229,8,1868.6449593948937,2,1,2,5,3
13002,125,26,3144.123391486306,4,3,4,11,1
13003,258,2,881.9312164044276,2,1,1,4,3
13004,322,28,1908.6029279999275,1,3,2,6,3
13005,236,48,4344.697427142585,2,5,5,12,1
13006,162,10,3651.028837109436,3,1,4,8,2
13007,42,39,287.3864492760579,5,4,1,10,1
13008,276,37,2574.3799418528115,2,4,3,9,2
13009,353,39,465.5636363553226,1,4,1,6,3
13010,68,21,4787.9071804533305,5,3,5,13,0
13011,173,28,1230.7567980061965,3,3,2,8,2
13012,331,38,4663.778918309934,1,4,5,10,1
13013,125,33,4171.701958372658,4,4,5,13,0
13014,170,11,2761.308529139524,3,2,3,8,2
13015,47,45,1688.159818486413,5,5,2,12,1
13016,261,44,4291.153936646346,2,5,5,12,1
13017,217,1,772.3906676733415,3,1,1,5,3
13018,305,47,908.0708283561611,1,5,1,7,2
13019,124,33,1131.366160060379,4,4,2,10,1
13020,293,3,2992.5075202524736,1,1,3,5,3
13021,162,26,1578.482870517046,3,3,2,8,2
13022,201,15,4946.0153829997635,3,2,5,10,1
13023,275,41,983.6140461128903,2,5,1,8,2
13024,206,14,4029.9943867952293,3,2,5,10,1
13025,40,23,488.2227303489099,5,3,1,9,2
13026,273,8,1773.698345874602,2,1,2,5,3
13027,188,36,1226.3748760282085,3,4,2,9,2
13028,355,20,4884.411383664964,1,2,5,8,2
13029,93,6,138.39559308950638,4,1,1,6,3
13030,42,33,3611.130933245793,5,4,4,13,0
13031,107,28,1246.133405750481,4,3,2,9,2
13032,328,38,4058.130826307229,1,4,5,10,1
13033,65,30,1563.0097539300675,5,3,2,10,1
13034,309,46,944.5483826073013,1,5,1,7,2
13035,135,43,3468.2688586020804,4,5,4,13,0
13036,24,17,1295.3069131826219,5,2,2,9,2
13037,28,9,2432.8788811922936,5,1,3,9,2
13038,62,28,666.3517773470844,5,3,1,9,2
13039,273,7,3625.744075105431,2,1,4,7,2
13040,229,46,2040.112663218825,2,5,3,10,1
13041,20,28,711.4929995919323,5,3,1,9,2
13042,3,17,3710.559283,5,2,4,11,1
13043,218,40,525.7773382383639,2,4,1,7,2
13044,307,48,2878.353908319741,1,5,3,9,2
13045,136,44,3041.350996753356,4,5,4,13,0
13046,3,44,4652.448996869741,5,5,5,15,0
13047,193,5,763.3926877407271,3,1,1,5,3
13048,73,5,3270.198335054046,5,1,4,10,1
13049,361,14,1910.0352211623804,1,2,2,5,3
13050,118,6,2010.0635916612837,4,1,3,8,2
13051,154,7,2514.107657899603,3,1,3,7,2
13052,209,17,1176.5852141245362,3,2,2,7,2
13053,34,9,2311.304362372766,5,1,3,9,2
13054,137,31,3437.3623803201667,4,4,4,12,1
13055,318,22,2290.994067346812,1,3,3,7,2
13056,120,45,222.1170523821355,4,5,1,10,1
13057,115,9,1296.5529752488405,4,1,2,7,2
13058,13,16,1763.7864616380168,5,2,2,9,2
13059,69,36,1780.058473079272,5,4,2,11,1
13060,333,34,414.2243936714158,1,4,1,6,3
13061,257,45,2253.357052570143,2,5,3,10,1
13062,89,13,3462.8256047529494,4,2,4,10,1
13063,47,19,252.87337006263033,5,2,1,8,2
13064,260,12,3757.1116201424206,2,2,4,8,2
13065,228,36,4775.974962787658,2,4,5,11,1
13066,180,10,56.597400294303185,3,1,1,5,3
13067,10,16,976.5246565014018,5,2,1,8,2
13068,284,28,2722.0040339030083,2,3,3,8,2
13069,126,19,1098.0669378848436,4,2,2,8,2
13070,134,40,3825.483898072561,4,4,4,12,1
13071,155,6,1567.550231647621,3,1,2,6,3
13072,248,4,1475.190158766411,2,1,2,5,3
13073,140,30,14.610140159375007,4,3,1,8,2
13074,318,39,1357.9296790594958,1,4,2,7,2
13075,176,31,1096.1759043152258,3,4,2,9,2
13076,323,46,1722.772426040954,1,5,2,8,2
13077,174,27,746.8066985912579,3,3,1,7,2
13078,74,45,2977.2968454482493,4,5,3,12,1
13079,351,21,1201.3203020267904,1,3,2,6,3
13080,143,37,4160.436815093398,4,4,5,13,0
13081,292,9,1429.9441542206841,1,1,2,4,3
13082,112,35,1062.2393013037051,4,4,2,10,1
13083,206,42,293.18929607777943,3,5,1,9,2
13084,131,47,3702.1343832085017,4,5,4,13,0
13085,110,21,2545.958793437404,4,3,3,10,1
13086,67,17,577.7771569286092,5,2,1,8,2
13087,86,24,1114.460565261383,4,3,2,9,2
13088,275,31,4993.608169578614,2,4,5,11,1
13089,227,6,4032.0833466500612,2,1,5,8,2
13090,325,35,1755.8487339802703,1,4,2,7,2
13091,10,37,2717.348604770566,5,4,3,12,1
13092,355,13,2085.92562291396,1,2,3,6,3
13093,288,25,191.5839313502738,2,3,1,6,3
13094,112,32,3895.598275972403,4,4,4,12,1
13095,24,1,3587.7607049839044,5,1,4,10,1
13096,291,49,2049.9235493344295,2,5,3,10,1
13097,339,35,4231.026713034331,1,4,5,10,1
13098,326,19,2678.34808349718,1,2,3,6,3
13099,168,12,335.3901126648991,3,2,1,6,3
13100,109,40,1304.4373883319379,4,4,2,10,1
13101,190,40,2314.246452068372,3,4,3,10,1
13102,355,47,526.2117011668778,1,5,1,7,2
13103,196,43,2859.695152385896,3,5,3,11,1
13104,33,20,611.6351268001732,5,2,1,8,2
13105,205,33,1010.5358455664002,3,4,1,8,2
13106,312,29,4470.97847007776,1,3,5,9,2
13107,182,16,4999.063816325757,3,2,5,10,1
13108,147,14,2755.764186792967,3,2,3,8,2
13109,268,7,3102.046564557507,2,1,4,7,2
13110,11,6,3989.181423162887,5,1,4,10,1
13111,70,21,3483.736086058406,5,3,4,12,1
13112,256,36,920.5080578270346,2,4,1,7,2
13113,219,22,2064.2409074468374,2,3,3,8,2
13114,297,40,2680.2314293529184,1,4,3,8,2
13115,362,19,1804.962840812073,1,2,2,5,3
13116,259,25,888.7697870913967,2,3,1,6,3
13117,3,3,3683.2055868662505,5,1,4,10,1
13118,84,36,1002.2435613459954,4,4,1,9,2
13119,156,45,1309.8247842220023,3,5,2,10,1
13120,151,34,1439.732879490878,3,4,2,9,2
13121,176,11,817.278360075078,3,2,1,6,3
13122,195,48,4249.26259874671,3,5,5,13,0
13123,107,42,3056.975431134834,4,5,4,13,0
13124,134,47,4175.393168660772,4,5,5,14,0
13125,276,27,2473.709274410455,2,3,3,8,2
13126,352,42,2602.6195702024697,1,5,3,9,2
13127,155,2,3084.561704370478,3,1,4,8,2
13128,277,6,1860.8885242142032,2,1,2,5,3
13129,236,46,2487.954633207207,2,5,3,10,1
